"";"ModelNumber";"Model";"Run";"Successes";"Successes_A";"Successes_B";"Allocated_A";"Allocated_B"
"1";"1. Random";"1. Random";1;374;96;278;504;496
"2";"6. Biased  coin";"6. Biased  coin";1;398;96;302;503;500
"3";"2. Neyman known";"2. Neyman known";1;434;93;341;430;570
"4";"3. RSIHR Known";"3. RSIHR Known";1;454;72;382;350;650
"5";"4. Rosenberger known";"4. Rosenberger known";1;537;30;507;150;850
"6";"5. Optimal adjusted";"5. Optimal adjusted";1;389;105;284;522;478
"7";"1. Random";"1. Random";2;404;106;298;494;506
"8";"6. Biased  coin";"6. Biased  coin";2;403;94;309;502;498
"9";"2. Neyman known";"2. Neyman known";2;424;83;341;455;545
"10";"3. RSIHR Known";"3. RSIHR Known";2;443;69;374;371;629
"11";"4. Rosenberger known";"4. Rosenberger known";2;549;30;519;154;846
"12";"5. Optimal adjusted";"5. Optimal adjusted";2;391;117;274;537;463
"13";"1. Random";"1. Random";3;408;108;300;497;503
"14";"6. Biased  coin";"6. Biased  coin";3;400;101;299;500;500
"15";"2. Neyman known";"2. Neyman known";3;389;93;296;491;509
"16";"3. RSIHR Known";"3. RSIHR Known";3;432;71;361;377;623
"17";"4. Rosenberger known";"4. Rosenberger known";3;521;26;495;156;844
"18";"5. Optimal adjusted";"5. Optimal adjusted";3;378;104;274;522;478
"19";"1. Random";"1. Random";4;419;100;319;495;505
"20";"6. Biased  coin";"6. Biased  coin";4;413;104;309;501;500
"21";"2. Neyman known";"2. Neyman known";4;453;104;349;462;538
"22";"3. RSIHR Known";"3. RSIHR Known";4;466;68;398;355;645
"23";"4. Rosenberger known";"4. Rosenberger known";4;570;27;543;118;882
"24";"5. Optimal adjusted";"5. Optimal adjusted";4;406;118;288;540;460
"25";"1. Random";"1. Random";5;408;104;304;512;488
"26";"6. Biased  coin";"6. Biased  coin";5;424;114;310;500;501
"27";"2. Neyman known";"2. Neyman known";5;404;86;318;451;549
"28";"3. RSIHR Known";"3. RSIHR Known";5;455;86;369;374;626
"29";"4. Rosenberger known";"4. Rosenberger known";5;553;23;530;118;882
"30";"5. Optimal adjusted";"5. Optimal adjusted";5;406;126;280;544;456
"31";"1. Random";"1. Random";6;382;87;295;512;488
"32";"6. Biased  coin";"6. Biased  coin";6;388;89;299;502;499
"33";"2. Neyman known";"2. Neyman known";6;405;72;333;437;563
"34";"3. RSIHR Known";"3. RSIHR Known";6;431;69;362;380;620
"35";"4. Rosenberger known";"4. Rosenberger known";6;543;17;526;142;858
"36";"5. Optimal adjusted";"5. Optimal adjusted";6;372;102;270;545;455
"37";"1. Random";"1. Random";7;384;82;302;509;491
"38";"6. Biased  coin";"6. Biased  coin";7;416;97;319;500;500
"39";"2. Neyman known";"2. Neyman known";7;436;87;349;443;557
"40";"3. RSIHR Known";"3. RSIHR Known";7;460;65;395;367;633
"41";"4. Rosenberger known";"4. Rosenberger known";7;552;28;524;147;853
"42";"5. Optimal adjusted";"5. Optimal adjusted";7;387;93;294;527;473
"43";"1. Random";"1. Random";8;399;105;294;520;480
"44";"6. Biased  coin";"6. Biased  coin";8;417;109;308;505;498
"45";"2. Neyman known";"2. Neyman known";8;434;91;343;457;543
"46";"3. RSIHR Known";"3. RSIHR Known";8;449;70;379;382;618
"47";"4. Rosenberger known";"4. Rosenberger known";8;557;21;536;147;853
"48";"5. Optimal adjusted";"5. Optimal adjusted";8;404;106;298;529;471
"49";"1. Random";"1. Random";9;412;90;322;498;502
"50";"6. Biased  coin";"6. Biased  coin";9;398;92;306;501;500
"51";"2. Neyman known";"2. Neyman known";9;408;76;332;446;554
"52";"3. RSIHR Known";"3. RSIHR Known";9;437;64;373;386;614
"53";"4. Rosenberger known";"4. Rosenberger known";9;552;38;514;149;851
"54";"5. Optimal adjusted";"5. Optimal adjusted";9;367;89;278;537;463
"55";"1. Random";"1. Random";10;422;91;331;490;510
"56";"6. Biased  coin";"6. Biased  coin";10;412;104;308;502;500
"57";"2. Neyman known";"2. Neyman known";10;440;89;351;450;550
"58";"3. RSIHR Known";"3. RSIHR Known";10;499;69;430;334;666
"59";"4. Rosenberger known";"4. Rosenberger known";10;578;28;550;135;865
"60";"5. Optimal adjusted";"5. Optimal adjusted";10;403;122;281;543;457
"61";"1. Random";"1. Random";11;408;85;323;463;537
"62";"6. Biased  coin";"6. Biased  coin";11;399;100;299;498;502
"63";"2. Neyman known";"2. Neyman known";11;417;102;315;479;521
"64";"3. RSIHR Known";"3. RSIHR Known";11;459;79;380;359;641
"65";"4. Rosenberger known";"4. Rosenberger known";11;530;33;497;148;852
"66";"5. Optimal adjusted";"5. Optimal adjusted";11;360;106;254;562;438
"67";"1. Random";"1. Random";12;396;93;303;496;504
"68";"6. Biased  coin";"6. Biased  coin";12;412;106;306;500;500
"69";"2. Neyman known";"2. Neyman known";12;420;109;311;482;518
"70";"3. RSIHR Known";"3. RSIHR Known";12;461;74;387;371;629
"71";"4. Rosenberger known";"4. Rosenberger known";12;547;31;516;147;853
"72";"5. Optimal adjusted";"5. Optimal adjusted";12;380;106;274;564;436
"73";"1. Random";"1. Random";13;413;98;315;480;520
"74";"6. Biased  coin";"6. Biased  coin";13;404;110;294;501;501
"75";"2. Neyman known";"2. Neyman known";13;417;93;324;451;549
"76";"3. RSIHR Known";"3. RSIHR Known";13;439;69;370;361;639
"77";"4. Rosenberger known";"4. Rosenberger known";13;524;29;495;154;846
"78";"5. Optimal adjusted";"5. Optimal adjusted";13;411;118;293;526;474
"79";"1. Random";"1. Random";14;396;90;306;503;497
"80";"6. Biased  coin";"6. Biased  coin";14;402;107;295;500;500
"81";"2. Neyman known";"2. Neyman known";14;419;102;317;478;522
"82";"3. RSIHR Known";"3. RSIHR Known";14;435;66;369;369;631
"83";"4. Rosenberger known";"4. Rosenberger known";14;546;32;514;145;855
"84";"5. Optimal adjusted";"5. Optimal adjusted";14;389;105;284;531;469
"85";"1. Random";"1. Random";15;383;101;282;508;492
"86";"6. Biased  coin";"6. Biased  coin";15;393;101;292;503;499
"87";"2. Neyman known";"2. Neyman known";15;411;96;315;436;564
"88";"3. RSIHR Known";"3. RSIHR Known";15;433;82;351;386;614
"89";"4. Rosenberger known";"4. Rosenberger known";15;539;27;512;138;862
"90";"5. Optimal adjusted";"5. Optimal adjusted";15;374;94;280;512;488
"91";"1. Random";"1. Random";16;403;102;301;488;512
"92";"6. Biased  coin";"6. Biased  coin";16;395;102;293;500;500
"93";"2. Neyman known";"2. Neyman known";16;423;89;334;451;549
"94";"3. RSIHR Known";"3. RSIHR Known";16;452;78;374;391;609
"95";"4. Rosenberger known";"4. Rosenberger known";16;550;35;515;153;847
"96";"5. Optimal adjusted";"5. Optimal adjusted";16;409;101;308;505;495
"97";"1. Random";"1. Random";17;390;89;301;487;513
"98";"6. Biased  coin";"6. Biased  coin";17;390;104;286;500;501
"99";"2. Neyman known";"2. Neyman known";17;402;86;316;449;551
"100";"3. RSIHR Known";"3. RSIHR Known";17;433;76;357;371;629
"101";"4. Rosenberger known";"4. Rosenberger known";17;520;28;492;141;859
"102";"5. Optimal adjusted";"5. Optimal adjusted";17;371;100;271;533;467
"103";"1. Random";"1. Random";18;415;95;320;475;525
"104";"6. Biased  coin";"6. Biased  coin";18;379;96;283;500;500
"105";"2. Neyman known";"2. Neyman known";18;409;83;326;449;551
"106";"3. RSIHR Known";"3. RSIHR Known";18;438;71;367;371;629
"107";"4. Rosenberger known";"4. Rosenberger known";18;535;32;503;157;843
"108";"5. Optimal adjusted";"5. Optimal adjusted";18;386;96;290;525;475
"109";"1. Random";"1. Random";19;401;100;301;494;506
"110";"6. Biased  coin";"6. Biased  coin";19;409;89;320;501;501
"111";"2. Neyman known";"2. Neyman known";19;424;87;337;449;551
"112";"3. RSIHR Known";"3. RSIHR Known";19;444;80;364;389;611
"113";"4. Rosenberger known";"4. Rosenberger known";19;557;23;534;127;873
"114";"5. Optimal adjusted";"5. Optimal adjusted";19;387;107;280;547;453
"115";"1. Random";"1. Random";20;399;91;308;496;504
"116";"6. Biased  coin";"6. Biased  coin";20;386;97;289;501;499
"117";"2. Neyman known";"2. Neyman known";20;430;85;345;421;579
"118";"3. RSIHR Known";"3. RSIHR Known";20;429;68;361;375;625
"119";"4. Rosenberger known";"4. Rosenberger known";20;537;20;517;123;877
"120";"5. Optimal adjusted";"5. Optimal adjusted";20;350;103;247;559;441
"121";"1. Random";"1. Random";21;402;108;294;507;493
"122";"6. Biased  coin";"6. Biased  coin";21;396;96;300;501;499
"123";"2. Neyman known";"2. Neyman known";21;416;96;320;467;533
"124";"3. RSIHR Known";"3. RSIHR Known";21;460;77;383;374;626
"125";"4. Rosenberger known";"4. Rosenberger known";21;528;33;495;175;825
"126";"5. Optimal adjusted";"5. Optimal adjusted";21;380;103;277;539;461
"127";"1. Random";"1. Random";22;379;90;289;497;503
"128";"6. Biased  coin";"6. Biased  coin";22;392;100;292;501;500
"129";"2. Neyman known";"2. Neyman known";22;420;79;341;422;578
"130";"3. RSIHR Known";"3. RSIHR Known";22;433;73;360;391;609
"131";"4. Rosenberger known";"4. Rosenberger known";22;525;31;494;156;844
"132";"5. Optimal adjusted";"5. Optimal adjusted";22;365;107;258;538;462
"133";"1. Random";"1. Random";23;383;93;290;515;485
"134";"6. Biased  coin";"6. Biased  coin";23;388;89;299;502;499
"135";"2. Neyman known";"2. Neyman known";23;418;82;336;446;554
"136";"3. RSIHR Known";"3. RSIHR Known";23;427;57;370;359;641
"137";"4. Rosenberger known";"4. Rosenberger known";23;540;22;518;138;862
"138";"5. Optimal adjusted";"5. Optimal adjusted";23;403;95;308;509;491
"139";"1. Random";"1. Random";24;391;87;304;493;507
"140";"6. Biased  coin";"6. Biased  coin";24;392;92;300;505;498
"141";"2. Neyman known";"2. Neyman known";24;398;84;314;476;524
"142";"3. RSIHR Known";"3. RSIHR Known";24;434;62;372;369;631
"143";"4. Rosenberger known";"4. Rosenberger known";24;536;28;508;134;866
"144";"5. Optimal adjusted";"5. Optimal adjusted";24;364;104;260;559;441
"145";"1. Random";"1. Random";25;417;96;321;477;523
"146";"6. Biased  coin";"6. Biased  coin";25;402;99;303;502;499
"147";"2. Neyman known";"2. Neyman known";25;428;80;348;444;556
"148";"3. RSIHR Known";"3. RSIHR Known";25;459;69;390;366;634
"149";"4. Rosenberger known";"4. Rosenberger known";25;561;36;525;143;857
"150";"5. Optimal adjusted";"5. Optimal adjusted";25;386;114;272;542;458
"151";"1. Random";"1. Random";26;397;84;313;474;526
"152";"6. Biased  coin";"6. Biased  coin";26;396;94;302;499;501
"153";"2. Neyman known";"2. Neyman known";26;420;82;338;452;548
"154";"3. RSIHR Known";"3. RSIHR Known";26;442;79;363;399;601
"155";"4. Rosenberger known";"4. Rosenberger known";26;548;28;520;142;858
"156";"5. Optimal adjusted";"5. Optimal adjusted";26;356;100;256;549;451
"157";"1. Random";"1. Random";27;405;110;295;519;481
"158";"6. Biased  coin";"6. Biased  coin";27;417;108;309;499;501
"159";"2. Neyman known";"2. Neyman known";27;421;84;337;448;552
"160";"3. RSIHR Known";"3. RSIHR Known";27;451;67;384;360;640
"161";"4. Rosenberger known";"4. Rosenberger known";27;562;24;538;130;870
"162";"5. Optimal adjusted";"5. Optimal adjusted";27;393;99;294;520;480
"163";"1. Random";"1. Random";28;424;111;313;495;505
"164";"6. Biased  coin";"6. Biased  coin";28;417;108;309;500;501
"165";"2. Neyman known";"2. Neyman known";28;430;97;333;476;524
"166";"3. RSIHR Known";"3. RSIHR Known";28;491;82;409;361;639
"167";"4. Rosenberger known";"4. Rosenberger known";28;560;37;523;162;838
"168";"5. Optimal adjusted";"5. Optimal adjusted";28;391;110;281;556;444
"169";"1. Random";"1. Random";29;398;90;308;484;516
"170";"6. Biased  coin";"6. Biased  coin";29;401;105;296;500;500
"171";"2. Neyman known";"2. Neyman known";29;431;97;334;442;558
"172";"3. RSIHR Known";"3. RSIHR Known";29;449;75;374;368;632
"173";"4. Rosenberger known";"4. Rosenberger known";29;563;31;532;121;879
"174";"5. Optimal adjusted";"5. Optimal adjusted";29;394;116;278;534;466
"175";"1. Random";"1. Random";30;374;97;277;513;487
"176";"6. Biased  coin";"6. Biased  coin";30;385;86;299;500;500
"177";"2. Neyman known";"2. Neyman known";30;415;85;330;441;559
"178";"3. RSIHR Known";"3. RSIHR Known";30;456;58;398;350;650
"179";"4. Rosenberger known";"4. Rosenberger known";30;531;24;507;134;866
"180";"5. Optimal adjusted";"5. Optimal adjusted";30;374;108;266;550;450
"181";"1. Random";"1. Random";31;427;115;312;499;501
"182";"6. Biased  coin";"6. Biased  coin";31;401;106;295;503;498
"183";"2. Neyman known";"2. Neyman known";31;416;84;332;445;555
"184";"3. RSIHR Known";"3. RSIHR Known";31;455;81;374;398;602
"185";"4. Rosenberger known";"4. Rosenberger known";31;571;27;544;127;873
"186";"5. Optimal adjusted";"5. Optimal adjusted";31;385;114;271;544;456
"187";"1. Random";"1. Random";32;396;107;289;503;497
"188";"6. Biased  coin";"6. Biased  coin";32;393;96;297;500;500
"189";"2. Neyman known";"2. Neyman known";32;412;71;341;420;580
"190";"3. RSIHR Known";"3. RSIHR Known";32;434;71;363;372;628
"191";"4. Rosenberger known";"4. Rosenberger known";32;550;25;525;135;865
"192";"5. Optimal adjusted";"5. Optimal adjusted";32;382;105;277;545;455
"193";"1. Random";"1. Random";33;415;102;313;492;508
"194";"6. Biased  coin";"6. Biased  coin";33;430;103;327;500;500
"195";"2. Neyman known";"2. Neyman known";33;437;80;357;430;570
"196";"3. RSIHR Known";"3. RSIHR Known";33;474;65;409;359;641
"197";"4. Rosenberger known";"4. Rosenberger known";33;568;24;544;141;859
"198";"5. Optimal adjusted";"5. Optimal adjusted";33;392;105;287;546;454
"199";"1. Random";"1. Random";34;384;108;276;510;490
"200";"6. Biased  coin";"6. Biased  coin";34;394;95;299;501;500
"201";"2. Neyman known";"2. Neyman known";34;418;89;329;436;564
"202";"3. RSIHR Known";"3. RSIHR Known";34;448;75;373;361;639
"203";"4. Rosenberger known";"4. Rosenberger known";34;534;35;499;150;850
"204";"5. Optimal adjusted";"5. Optimal adjusted";34;396;113;283;533;467
"205";"1. Random";"1. Random";35;432;107;325;509;491
"206";"6. Biased  coin";"6. Biased  coin";35;422;110;312;501;500
"207";"2. Neyman known";"2. Neyman known";35;438;101;337;463;537
"208";"3. RSIHR Known";"3. RSIHR Known";35;477;72;405;353;647
"209";"4. Rosenberger known";"4. Rosenberger known";35;571;42;529;164;836
"210";"5. Optimal adjusted";"5. Optimal adjusted";35;396;118;278;554;446
"211";"1. Random";"1. Random";36;405;95;310;511;489
"212";"6. Biased  coin";"6. Biased  coin";36;414;92;322;502;500
"213";"2. Neyman known";"2. Neyman known";36;438;88;350;433;567
"214";"3. RSIHR Known";"3. RSIHR Known";36;482;65;417;365;635
"215";"4. Rosenberger known";"4. Rosenberger known";36;563;23;540;140;860
"216";"5. Optimal adjusted";"5. Optimal adjusted";36;375;86;289;525;475
"217";"1. Random";"1. Random";37;440;105;335;472;528
"218";"6. Biased  coin";"6. Biased  coin";37;433;105;328;502;500
"219";"2. Neyman known";"2. Neyman known";37;448;79;369;429;571
"220";"3. RSIHR Known";"3. RSIHR Known";37;477;66;411;361;639
"221";"4. Rosenberger known";"4. Rosenberger known";37;582;22;560;127;873
"222";"5. Optimal adjusted";"5. Optimal adjusted";37;413;111;302;522;478
"223";"1. Random";"1. Random";38;374;94;280;513;487
"224";"6. Biased  coin";"6. Biased  coin";38;377;96;281;500;500
"225";"2. Neyman known";"2. Neyman known";38;405;88;317;458;542
"226";"3. RSIHR Known";"3. RSIHR Known";38;444;75;369;370;630
"227";"4. Rosenberger known";"4. Rosenberger known";38;563;27;536;137;863
"228";"5. Optimal adjusted";"5. Optimal adjusted";38;388;100;288;528;472
"229";"1. Random";"1. Random";39;417;103;314;515;485
"230";"6. Biased  coin";"6. Biased  coin";39;393;99;294;503;497
"231";"2. Neyman known";"2. Neyman known";39;422;91;331;450;550
"232";"3. RSIHR Known";"3. RSIHR Known";39;442;79;363;397;603
"233";"4. Rosenberger known";"4. Rosenberger known";39;551;30;521;130;870
"234";"5. Optimal adjusted";"5. Optimal adjusted";39;382;96;286;529;471
"235";"1. Random";"1. Random";40;377;89;288;524;476
"236";"6. Biased  coin";"6. Biased  coin";40;395;93;302;501;500
"237";"2. Neyman known";"2. Neyman known";40;376;81;295;483;517
"238";"3. RSIHR Known";"3. RSIHR Known";40;434;72;362;390;610
"239";"4. Rosenberger known";"4. Rosenberger known";40;521;32;489;176;824
"240";"5. Optimal adjusted";"5. Optimal adjusted";40;389;100;289;504;496
"241";"1. Random";"1. Random";41;395;85;310;495;505
"242";"6. Biased  coin";"6. Biased  coin";41;372;85;287;502;498
"243";"2. Neyman known";"2. Neyman known";41;402;68;334;455;545
"244";"3. RSIHR Known";"3. RSIHR Known";41;442;66;376;371;629
"245";"4. Rosenberger known";"4. Rosenberger known";41;543;19;524;130;870
"246";"5. Optimal adjusted";"5. Optimal adjusted";41;366;96;270;522;478
"247";"1. Random";"1. Random";42;417;94;323;479;521
"248";"6. Biased  coin";"6. Biased  coin";42;415;102;313;501;499
"249";"2. Neyman known";"2. Neyman known";42;427;81;346;445;555
"250";"3. RSIHR Known";"3. RSIHR Known";42;449;72;377;388;612
"251";"4. Rosenberger known";"4. Rosenberger known";42;547;30;517;149;851
"252";"5. Optimal adjusted";"5. Optimal adjusted";42;386;116;270;556;444
"253";"1. Random";"1. Random";43;411;102;309;503;497
"254";"6. Biased  coin";"6. Biased  coin";43;399;105;294;501;500
"255";"2. Neyman known";"2. Neyman known";43;412;85;327;449;551
"256";"3. RSIHR Known";"3. RSIHR Known";43;444;85;359;385;615
"257";"4. Rosenberger known";"4. Rosenberger known";43;525;29;496;158;842
"258";"5. Optimal adjusted";"5. Optimal adjusted";43;385;123;262;545;455
"259";"1. Random";"1. Random";44;394;76;318;479;521
"260";"6. Biased  coin";"6. Biased  coin";44;409;87;322;501;499
"261";"2. Neyman known";"2. Neyman known";44;424;77;347;437;563
"262";"3. RSIHR Known";"3. RSIHR Known";44;489;81;408;357;643
"263";"4. Rosenberger known";"4. Rosenberger known";44;576;20;556;128;872
"264";"5. Optimal adjusted";"5. Optimal adjusted";44;391;93;298;539;461
"265";"1. Random";"1. Random";45;369;102;267;532;468
"266";"6. Biased  coin";"6. Biased  coin";45;386;92;294;503;499
"267";"2. Neyman known";"2. Neyman known";45;421;88;333;438;562
"268";"3. RSIHR Known";"3. RSIHR Known";45;449;59;390;353;647
"269";"4. Rosenberger known";"4. Rosenberger known";45;548;37;511;136;864
"270";"5. Optimal adjusted";"5. Optimal adjusted";45;368;101;267;549;451
"271";"1. Random";"1. Random";46;409;94;315;506;494
"272";"6. Biased  coin";"6. Biased  coin";46;424;96;328;503;500
"273";"2. Neyman known";"2. Neyman known";46;415;86;329;452;548
"274";"3. RSIHR Known";"3. RSIHR Known";46;441;74;367;383;617
"275";"4. Rosenberger known";"4. Rosenberger known";46;571;20;551;114;886
"276";"5. Optimal adjusted";"5. Optimal adjusted";46;405;106;299;527;473
"277";"1. Random";"1. Random";47;365;103;262;536;464
"278";"6. Biased  coin";"6. Biased  coin";47;416;114;302;500;500
"279";"2. Neyman known";"2. Neyman known";47;411;104;307;482;518
"280";"3. RSIHR Known";"3. RSIHR Known";47;425;68;357;386;614
"281";"4. Rosenberger known";"4. Rosenberger known";47;542;29;513;138;862
"282";"5. Optimal adjusted";"5. Optimal adjusted";47;391;101;290;532;468
"283";"1. Random";"1. Random";48;399;99;300;510;490
"284";"6. Biased  coin";"6. Biased  coin";48;396;100;296;501;499
"285";"2. Neyman known";"2. Neyman known";48;413;100;313;469;531
"286";"3. RSIHR Known";"3. RSIHR Known";48;448;74;374;384;616
"287";"4. Rosenberger known";"4. Rosenberger known";48;549;40;509;160;840
"288";"5. Optimal adjusted";"5. Optimal adjusted";48;384;110;274;552;448
"289";"1. Random";"1. Random";49;393;92;301;479;521
"290";"6. Biased  coin";"6. Biased  coin";49;384;97;287;499;501
"291";"2. Neyman known";"2. Neyman known";49;382;72;310;453;547
"292";"3. RSIHR Known";"3. RSIHR Known";49;425;64;361;373;627
"293";"4. Rosenberger known";"4. Rosenberger known";49;520;25;495;134;866
"294";"5. Optimal adjusted";"5. Optimal adjusted";49;381;120;261;556;444
"295";"1. Random";"1. Random";50;416;114;302;490;510
"296";"6. Biased  coin";"6. Biased  coin";50;407;103;304;500;500
"297";"2. Neyman known";"2. Neyman known";50;429;94;335;457;543
"298";"3. RSIHR Known";"3. RSIHR Known";50;453;90;363;397;603
"299";"4. Rosenberger known";"4. Rosenberger known";50;543;27;516;127;873
"300";"5. Optimal adjusted";"5. Optimal adjusted";50;391;124;267;540;460
"301";"1. Random";"1. Random";51;432;89;343;482;518
"302";"6. Biased  coin";"6. Biased  coin";51;408;99;309;501;499
"303";"2. Neyman known";"2. Neyman known";51;439;88;351;436;564
"304";"3. RSIHR Known";"3. RSIHR Known";51;465;76;389;388;612
"305";"4. Rosenberger known";"4. Rosenberger known";51;561;28;533;156;844
"306";"5. Optimal adjusted";"5. Optimal adjusted";51;415;105;310;525;475
"307";"1. Random";"1. Random";52;407;102;305;476;524
"308";"6. Biased  coin";"6. Biased  coin";52;378;99;279;504;500
"309";"2. Neyman known";"2. Neyman known";52;422;93;329;447;553
"310";"3. RSIHR Known";"3. RSIHR Known";52;439;81;358;369;631
"311";"4. Rosenberger known";"4. Rosenberger known";52;540;45;495;157;843
"312";"5. Optimal adjusted";"5. Optimal adjusted";52;394;115;279;546;454
"313";"1. Random";"1. Random";53;369;94;275;520;480
"314";"6. Biased  coin";"6. Biased  coin";53;385;96;289;500;501
"315";"2. Neyman known";"2. Neyman known";53;408;98;310;461;539
"316";"3. RSIHR Known";"3. RSIHR Known";53;416;64;352;377;623
"317";"4. Rosenberger known";"4. Rosenberger known";53;525;45;480;167;833
"318";"5. Optimal adjusted";"5. Optimal adjusted";53;361;108;253;549;451
"319";"1. Random";"1. Random";54;409;112;297;495;505
"320";"6. Biased  coin";"6. Biased  coin";54;380;98;282;502;500
"321";"2. Neyman known";"2. Neyman known";54;401;99;302;472;528
"322";"3. RSIHR Known";"3. RSIHR Known";54;443;70;373;325;675
"323";"4. Rosenberger known";"4. Rosenberger known";54;525;35;490;137;863
"324";"5. Optimal adjusted";"5. Optimal adjusted";54;384;125;259;555;445
"325";"1. Random";"1. Random";55;416;115;301;512;488
"326";"6. Biased  coin";"6. Biased  coin";55;431;121;310;500;500
"327";"2. Neyman known";"2. Neyman known";55;431;109;322;471;529
"328";"3. RSIHR Known";"3. RSIHR Known";55;482;96;386;367;633
"329";"4. Rosenberger known";"4. Rosenberger known";55;572;45;527;142;858
"330";"5. Optimal adjusted";"5. Optimal adjusted";55;390;119;271;553;447
"331";"1. Random";"1. Random";56;424;85;339;466;534
"332";"6. Biased  coin";"6. Biased  coin";56;414;92;322;501;500
"333";"2. Neyman known";"2. Neyman known";56;445;82;363;449;551
"334";"3. RSIHR Known";"3. RSIHR Known";56;462;64;398;370;630
"335";"4. Rosenberger known";"4. Rosenberger known";56;562;18;544;136;864
"336";"5. Optimal adjusted";"5. Optimal adjusted";56;409;99;310;526;474
"337";"1. Random";"1. Random";57;404;105;299;506;494
"338";"6. Biased  coin";"6. Biased  coin";57;419;109;310;500;501
"339";"2. Neyman known";"2. Neyman known";57;419;92;327;456;544
"340";"3. RSIHR Known";"3. RSIHR Known";57;451;81;370;375;625
"341";"4. Rosenberger known";"4. Rosenberger known";57;560;31;529;145;855
"342";"5. Optimal adjusted";"5. Optimal adjusted";57;408;127;281;544;456
"343";"1. Random";"1. Random";58;376;92;284;504;496
"344";"6. Biased  coin";"6. Biased  coin";58;408;106;302;500;500
"345";"2. Neyman known";"2. Neyman known";58;405;81;324;454;546
"346";"3. RSIHR Known";"3. RSIHR Known";58;438;66;372;352;648
"347";"4. Rosenberger known";"4. Rosenberger known";58;521;34;487;167;833
"348";"5. Optimal adjusted";"5. Optimal adjusted";58;377;89;288;540;460
"349";"1. Random";"1. Random";59;429;87;342;476;524
"350";"6. Biased  coin";"6. Biased  coin";59;432;110;322;500;500
"351";"2. Neyman known";"2. Neyman known";59;428;90;338;482;518
"352";"3. RSIHR Known";"3. RSIHR Known";59;491;66;425;343;657
"353";"4. Rosenberger known";"4. Rosenberger known";59;588;27;561;124;876
"354";"5. Optimal adjusted";"5. Optimal adjusted";59;423;94;329;500;500
"355";"1. Random";"1. Random";60;384;98;286;509;491
"356";"6. Biased  coin";"6. Biased  coin";60;386;95;291;501;500
"357";"2. Neyman known";"2. Neyman known";60;426;95;331;461;539
"358";"3. RSIHR Known";"3. RSIHR Known";60;461;79;382;371;629
"359";"4. Rosenberger known";"4. Rosenberger known";60;527;25;502;150;850
"360";"5. Optimal adjusted";"5. Optimal adjusted";60;375;105;270;520;480
"361";"1. Random";"1. Random";61;429;104;325;488;512
"362";"6. Biased  coin";"6. Biased  coin";61;397;93;304;502;499
"363";"2. Neyman known";"2. Neyman known";61;430;78;352;428;572
"364";"3. RSIHR Known";"3. RSIHR Known";61;478;75;403;359;641
"365";"4. Rosenberger known";"4. Rosenberger known";61;578;28;550;145;855
"366";"5. Optimal adjusted";"5. Optimal adjusted";61;394;93;301;514;486
"367";"1. Random";"1. Random";62;408;96;312;494;506
"368";"6. Biased  coin";"6. Biased  coin";62;402;101;301;501;500
"369";"2. Neyman known";"2. Neyman known";62;421;83;338;450;550
"370";"3. RSIHR Known";"3. RSIHR Known";62;470;70;400;357;643
"371";"4. Rosenberger known";"4. Rosenberger known";62;576;24;552;122;878
"372";"5. Optimal adjusted";"5. Optimal adjusted";62;400;104;296;529;471
"373";"1. Random";"1. Random";63;432;91;341;466;534
"374";"6. Biased  coin";"6. Biased  coin";63;405;102;303;500;500
"375";"2. Neyman known";"2. Neyman known";63;422;87;335;477;523
"376";"3. RSIHR Known";"3. RSIHR Known";63;451;67;384;372;628
"377";"4. Rosenberger known";"4. Rosenberger known";63;558;32;526;153;847
"378";"5. Optimal adjusted";"5. Optimal adjusted";63;381;111;270;565;435
"379";"1. Random";"1. Random";64;413;100;313;491;509
"380";"6. Biased  coin";"6. Biased  coin";64;424;106;318;504;499
"381";"2. Neyman known";"2. Neyman known";64;439;88;351;448;552
"382";"3. RSIHR Known";"3. RSIHR Known";64;463;71;392;365;635
"383";"4. Rosenberger known";"4. Rosenberger known";64;569;24;545;132;868
"384";"5. Optimal adjusted";"5. Optimal adjusted";64;414;115;299;541;459
"385";"1. Random";"1. Random";65;406;97;309;503;497
"386";"6. Biased  coin";"6. Biased  coin";65;403;104;299;500;500
"387";"2. Neyman known";"2. Neyman known";65;420;89;331;458;542
"388";"3. RSIHR Known";"3. RSIHR Known";65;450;71;379;370;630
"389";"4. Rosenberger known";"4. Rosenberger known";65;553;27;526;136;864
"390";"5. Optimal adjusted";"5. Optimal adjusted";65;401;105;296;522;478
"391";"1. Random";"1. Random";66;385;104;281;509;491
"392";"6. Biased  coin";"6. Biased  coin";66;395;107;288;504;500
"393";"2. Neyman known";"2. Neyman known";66;414;90;324;437;563
"394";"3. RSIHR Known";"3. RSIHR Known";66;430;78;352;379;621
"395";"4. Rosenberger known";"4. Rosenberger known";66;541;42;499;148;852
"396";"5. Optimal adjusted";"5. Optimal adjusted";66;386;109;277;545;455
"397";"1. Random";"1. Random";67;398;96;302;506;494
"398";"6. Biased  coin";"6. Biased  coin";67;407;92;315;500;500
"399";"2. Neyman known";"2. Neyman known";67;432;89;343;469;531
"400";"3. RSIHR Known";"3. RSIHR Known";67;461;74;387;367;633
"401";"4. Rosenberger known";"4. Rosenberger known";67;573;39;534;148;852
"402";"5. Optimal adjusted";"5. Optimal adjusted";67;379;107;272;539;461
"403";"1. Random";"1. Random";68;420;101;319;480;520
"404";"6. Biased  coin";"6. Biased  coin";68;406;103;303;502;500
"405";"2. Neyman known";"2. Neyman known";68;438;89;349;429;571
"406";"3. RSIHR Known";"3. RSIHR Known";68;469;68;401;362;638
"407";"4. Rosenberger known";"4. Rosenberger known";68;544;29;515;157;843
"408";"5. Optimal adjusted";"5. Optimal adjusted";68;400;119;281;548;452
"409";"1. Random";"1. Random";69;414;112;302;517;483
"410";"6. Biased  coin";"6. Biased  coin";69;407;101;306;500;500
"411";"2. Neyman known";"2. Neyman known";69;441;102;339;451;549
"412";"3. RSIHR Known";"3. RSIHR Known";69;468;66;402;364;636
"413";"4. Rosenberger known";"4. Rosenberger known";69;564;28;536;122;878
"414";"5. Optimal adjusted";"5. Optimal adjusted";69;399;121;278;542;458
"415";"1. Random";"1. Random";70;408;99;309;492;508
"416";"6. Biased  coin";"6. Biased  coin";70;383;88;295;500;501
"417";"2. Neyman known";"2. Neyman known";70;415;80;335;453;547
"418";"3. RSIHR Known";"3. RSIHR Known";70;430;51;379;374;626
"419";"4. Rosenberger known";"4. Rosenberger known";70;566;37;529;147;853
"420";"5. Optimal adjusted";"5. Optimal adjusted";70;379;92;287;544;456
"421";"1. Random";"1. Random";71;394;88;306;487;513
"422";"6. Biased  coin";"6. Biased  coin";71;380;92;288;501;500
"423";"2. Neyman known";"2. Neyman known";71;404;81;323;433;567
"424";"3. RSIHR Known";"3. RSIHR Known";71;450;63;387;366;634
"425";"4. Rosenberger known";"4. Rosenberger known";71;562;31;531;123;877
"426";"5. Optimal adjusted";"5. Optimal adjusted";71;396;106;290;531;469
"427";"1. Random";"1. Random";72;431;95;336;474;526
"428";"6. Biased  coin";"6. Biased  coin";72;436;113;323;501;500
"429";"2. Neyman known";"2. Neyman known";72;416;82;334;454;546
"430";"3. RSIHR Known";"3. RSIHR Known";72;465;75;390;354;646
"431";"4. Rosenberger known";"4. Rosenberger known";72;540;27;513;169;831
"432";"5. Optimal adjusted";"5. Optimal adjusted";72;378;111;267;542;458
"433";"1. Random";"1. Random";73;426;97;329;493;507
"434";"6. Biased  coin";"6. Biased  coin";73;388;82;306;499;501
"435";"2. Neyman known";"2. Neyman known";73;440;83;357;422;578
"436";"3. RSIHR Known";"3. RSIHR Known";73;437;60;377;376;624
"437";"4. Rosenberger known";"4. Rosenberger known";73;569;35;534;148;852
"438";"5. Optimal adjusted";"5. Optimal adjusted";73;379;102;277;540;460
"439";"1. Random";"1. Random";74;389;98;291;494;506
"440";"6. Biased  coin";"6. Biased  coin";74;373;88;285;499;502
"441";"2. Neyman known";"2. Neyman known";74;416;84;332;429;571
"442";"3. RSIHR Known";"3. RSIHR Known";74;431;61;370;355;645
"443";"4. Rosenberger known";"4. Rosenberger known";74;532;47;485;165;835
"444";"5. Optimal adjusted";"5. Optimal adjusted";74;378;111;267;537;463
"445";"1. Random";"1. Random";75;410;104;306;500;500
"446";"6. Biased  coin";"6. Biased  coin";75;407;104;303;502;498
"447";"2. Neyman known";"2. Neyman known";75;411;80;331;454;546
"448";"3. RSIHR Known";"3. RSIHR Known";75;463;99;364;396;604
"449";"4. Rosenberger known";"4. Rosenberger known";75;552;29;523;136;864
"450";"5. Optimal adjusted";"5. Optimal adjusted";75;370;102;268;539;461
"451";"1. Random";"1. Random";76;389;106;283;505;495
"452";"6. Biased  coin";"6. Biased  coin";76;383;94;289;499;501
"453";"2. Neyman known";"2. Neyman known";76;411;105;306;461;539
"454";"3. RSIHR Known";"3. RSIHR Known";76;438;82;356;372;628
"455";"4. Rosenberger known";"4. Rosenberger known";76;516;37;479;166;834
"456";"5. Optimal adjusted";"5. Optimal adjusted";76;400;101;299;501;499
"457";"1. Random";"1. Random";77;431;111;320;495;505
"458";"6. Biased  coin";"6. Biased  coin";77;410;113;297;499;502
"459";"2. Neyman known";"2. Neyman known";77;405;98;307;482;518
"460";"3. RSIHR Known";"3. RSIHR Known";77;462;81;381;374;626
"461";"4. Rosenberger known";"4. Rosenberger known";77;545;28;517;160;840
"462";"5. Optimal adjusted";"5. Optimal adjusted";77;392;117;275;541;459
"463";"1. Random";"1. Random";78;380;91;289;517;483
"464";"6. Biased  coin";"6. Biased  coin";78;389;93;296;501;500
"465";"2. Neyman known";"2. Neyman known";78;409;87;322;460;540
"466";"3. RSIHR Known";"3. RSIHR Known";78;468;78;390;353;647
"467";"4. Rosenberger known";"4. Rosenberger known";78;529;18;511;137;863
"468";"5. Optimal adjusted";"5. Optimal adjusted";78;363;93;270;521;479
"469";"1. Random";"1. Random";79;395;92;303;497;503
"470";"6. Biased  coin";"6. Biased  coin";79;414;105;309;500;500
"471";"2. Neyman known";"2. Neyman known";79;430;83;347;432;568
"472";"3. RSIHR Known";"3. RSIHR Known";79;451;75;376;383;617
"473";"4. Rosenberger known";"4. Rosenberger known";79;557;30;527;130;870
"474";"5. Optimal adjusted";"5. Optimal adjusted";79;405;105;300;515;485
"475";"1. Random";"1. Random";80;366;83;283;511;489
"476";"6. Biased  coin";"6. Biased  coin";80;393;87;306;501;501
"477";"2. Neyman known";"2. Neyman known";80;428;97;331;457;543
"478";"3. RSIHR Known";"3. RSIHR Known";80;455;83;372;385;615
"479";"4. Rosenberger known";"4. Rosenberger known";80;559;31;528;131;869
"480";"5. Optimal adjusted";"5. Optimal adjusted";80;366;98;268;546;454
"481";"1. Random";"1. Random";81;413;105;308;492;508
"482";"6. Biased  coin";"6. Biased  coin";81;389;91;298;500;500
"483";"2. Neyman known";"2. Neyman known";81;439;97;342;452;548
"484";"3. RSIHR Known";"3. RSIHR Known";81;463;80;383;369;631
"485";"4. Rosenberger known";"4. Rosenberger known";81;547;30;517;148;852
"486";"5. Optimal adjusted";"5. Optimal adjusted";81;396;92;304;499;501
"487";"1. Random";"1. Random";82;406;97;309;488;512
"488";"6. Biased  coin";"6. Biased  coin";82;388;96;292;501;500
"489";"2. Neyman known";"2. Neyman known";82;391;88;303;463;537
"490";"3. RSIHR Known";"3. RSIHR Known";82;433;71;362;381;619
"491";"4. Rosenberger known";"4. Rosenberger known";82;538;28;510;132;868
"492";"5. Optimal adjusted";"5. Optimal adjusted";82;388;105;283;532;468
"493";"1. Random";"1. Random";83;386;96;290;526;474
"494";"6. Biased  coin";"6. Biased  coin";83;393;95;298;502;500
"495";"2. Neyman known";"2. Neyman known";83;436;92;344;448;552
"496";"3. RSIHR Known";"3. RSIHR Known";83;469;69;400;372;628
"497";"4. Rosenberger known";"4. Rosenberger known";83;570;37;533;144;856
"498";"5. Optimal adjusted";"5. Optimal adjusted";83;388;116;272;556;444
"499";"1. Random";"1. Random";84;393;98;295;495;505
"500";"6. Biased  coin";"6. Biased  coin";84;391;96;295;502;499
"501";"2. Neyman known";"2. Neyman known";84;425;76;349;437;563
"502";"3. RSIHR Known";"3. RSIHR Known";84;442;61;381;349;651
"503";"4. Rosenberger known";"4. Rosenberger known";84;533;24;509;161;839
"504";"5. Optimal adjusted";"5. Optimal adjusted";84;387;99;288;535;465
"505";"1. Random";"1. Random";85;411;93;318;485;515
"506";"6. Biased  coin";"6. Biased  coin";85;410;101;309;501;499
"507";"2. Neyman known";"2. Neyman known";85;429;85;344;446;554
"508";"3. RSIHR Known";"3. RSIHR Known";85;438;52;386;362;638
"509";"4. Rosenberger known";"4. Rosenberger known";85;567;32;535;149;851
"510";"5. Optimal adjusted";"5. Optimal adjusted";85;383;95;288;525;475
"511";"1. Random";"1. Random";86;408;95;313;496;504
"512";"6. Biased  coin";"6. Biased  coin";86;417;113;304;501;499
"513";"2. Neyman known";"2. Neyman known";86;438;99;339;445;555
"514";"3. RSIHR Known";"3. RSIHR Known";86;475;74;401;338;662
"515";"4. Rosenberger known";"4. Rosenberger known";86;561;31;530;132;868
"516";"5. Optimal adjusted";"5. Optimal adjusted";86;388;115;273;550;450
"517";"1. Random";"1. Random";87;372;99;273;508;492
"518";"6. Biased  coin";"6. Biased  coin";87;390;94;296;501;501
"519";"2. Neyman known";"2. Neyman known";87;418;92;326;448;552
"520";"3. RSIHR Known";"3. RSIHR Known";87;432;65;367;369;631
"521";"4. Rosenberger known";"4. Rosenberger known";87;508;22;486;142;858
"522";"5. Optimal adjusted";"5. Optimal adjusted";87;379;93;286;514;486
"523";"1. Random";"1. Random";88;402;106;296;522;478
"524";"6. Biased  coin";"6. Biased  coin";88;406;91;315;503;500
"525";"2. Neyman known";"2. Neyman known";88;424;86;338;424;576
"526";"3. RSIHR Known";"3. RSIHR Known";88;443;61;382;345;655
"527";"4. Rosenberger known";"4. Rosenberger known";88;543;26;517;129;871
"528";"5. Optimal adjusted";"5. Optimal adjusted";88;386;104;282;537;463
"529";"1. Random";"1. Random";89;406;108;298;522;478
"530";"6. Biased  coin";"6. Biased  coin";89;413;106;307;499;501
"531";"2. Neyman known";"2. Neyman known";89;416;100;316;450;550
"532";"3. RSIHR Known";"3. RSIHR Known";89;458;79;379;390;610
"533";"4. Rosenberger known";"4. Rosenberger known";89;561;28;533;122;878
"534";"5. Optimal adjusted";"5. Optimal adjusted";89;403;107;296;520;480
"535";"1. Random";"1. Random";90;367;85;282;526;474
"536";"6. Biased  coin";"6. Biased  coin";90;403;97;306;500;500
"537";"2. Neyman known";"2. Neyman known";90;405;72;333;455;545
"538";"3. RSIHR Known";"3. RSIHR Known";90;470;65;405;337;663
"539";"4. Rosenberger known";"4. Rosenberger known";90;543;31;512;138;862
"540";"5. Optimal adjusted";"5. Optimal adjusted";90;374;96;278;535;465
"541";"1. Random";"1. Random";91;398;101;297;509;491
"542";"6. Biased  coin";"6. Biased  coin";91;400;102;298;502;500
"543";"2. Neyman known";"2. Neyman known";91;403;88;315;446;554
"544";"3. RSIHR Known";"3. RSIHR Known";91;452;77;375;377;623
"545";"4. Rosenberger known";"4. Rosenberger known";91;544;24;520;137;863
"546";"5. Optimal adjusted";"5. Optimal adjusted";91;394;99;295;504;496
"547";"1. Random";"1. Random";92;388;92;296;513;487
"548";"6. Biased  coin";"6. Biased  coin";92;408;100;308;502;499
"549";"2. Neyman known";"2. Neyman known";92;456;91;365;435;565
"550";"3. RSIHR Known";"3. RSIHR Known";92;466;85;381;366;634
"551";"4. Rosenberger known";"4. Rosenberger known";92;546;33;513;156;844
"552";"5. Optimal adjusted";"5. Optimal adjusted";92;387;110;277;543;457
"553";"1. Random";"1. Random";93;393;105;288;525;475
"554";"6. Biased  coin";"6. Biased  coin";93;408;101;307;502;498
"555";"2. Neyman known";"2. Neyman known";93;410;91;319;462;538
"556";"3. RSIHR Known";"3. RSIHR Known";93;449;85;364;391;609
"557";"4. Rosenberger known";"4. Rosenberger known";93;550;29;521;153;847
"558";"5. Optimal adjusted";"5. Optimal adjusted";93;409;105;304;514;486
"559";"1. Random";"1. Random";94;411;99;312;508;492
"560";"6. Biased  coin";"6. Biased  coin";94;389;88;301;502;500
"561";"2. Neyman known";"2. Neyman known";94;429;79;350;419;581
"562";"3. RSIHR Known";"3. RSIHR Known";94;463;68;395;362;638
"563";"4. Rosenberger known";"4. Rosenberger known";94;538;30;508;163;837
"564";"5. Optimal adjusted";"5. Optimal adjusted";94;409;110;299;531;469
"565";"1. Random";"1. Random";95;408;100;308;491;509
"566";"6. Biased  coin";"6. Biased  coin";95;400;94;306;501;499
"567";"2. Neyman known";"2. Neyman known";95;434;76;358;419;581
"568";"3. RSIHR Known";"3. RSIHR Known";95;469;66;403;352;648
"569";"4. Rosenberger known";"4. Rosenberger known";95;553;16;537;136;864
"570";"5. Optimal adjusted";"5. Optimal adjusted";95;392;100;292;526;474
"571";"1. Random";"1. Random";96;397;104;293;506;494
"572";"6. Biased  coin";"6. Biased  coin";96;413;101;312;500;500
"573";"2. Neyman known";"2. Neyman known";96;424;88;336;427;573
"574";"3. RSIHR Known";"3. RSIHR Known";96;449;70;379;370;630
"575";"4. Rosenberger known";"4. Rosenberger known";96;545;30;515;140;860
"576";"5. Optimal adjusted";"5. Optimal adjusted";96;386;109;277;554;446
"577";"1. Random";"1. Random";97;376;91;285;515;485
"578";"6. Biased  coin";"6. Biased  coin";97;394;95;299;503;499
"579";"2. Neyman known";"2. Neyman known";97;401;77;324;427;573
"580";"3. RSIHR Known";"3. RSIHR Known";97;458;69;389;344;656
"581";"4. Rosenberger known";"4. Rosenberger known";97;539;27;512;132;868
"582";"5. Optimal adjusted";"5. Optimal adjusted";97;388;103;285;536;464
"583";"1. Random";"1. Random";98;400;93;307;484;516
"584";"6. Biased  coin";"6. Biased  coin";98;395;96;299;506;497
"585";"2. Neyman known";"2. Neyman known";98;393;76;317;454;546
"586";"3. RSIHR Known";"3. RSIHR Known";98;433;71;362;368;632
"587";"4. Rosenberger known";"4. Rosenberger known";98;527;33;494;159;841
"588";"5. Optimal adjusted";"5. Optimal adjusted";98;385;121;264;560;440
"589";"1. Random";"1. Random";99;381;90;291;503;497
"590";"6. Biased  coin";"6. Biased  coin";99;381;91;290;500;500
"591";"2. Neyman known";"2. Neyman known";99;398;89;309;452;548
"592";"3. RSIHR Known";"3. RSIHR Known";99;426;70;356;382;618
"593";"4. Rosenberger known";"4. Rosenberger known";99;516;27;489;166;834
"594";"5. Optimal adjusted";"5. Optimal adjusted";99;362;85;277;521;479
"595";"1. Random";"1. Random";100;395;106;289;519;481
"596";"6. Biased  coin";"6. Biased  coin";100;428;120;308;500;500
"597";"2. Neyman known";"2. Neyman known";100;446;107;339;455;545
"598";"3. RSIHR Known";"3. RSIHR Known";100;463;80;383;363;637
"599";"4. Rosenberger known";"4. Rosenberger known";100;556;38;518;149;851
"600";"5. Optimal adjusted";"5. Optimal adjusted";100;400;118;282;534;466
"601";"1. Random";"1. Random";101;406;97;309;490;510
"602";"6. Biased  coin";"6. Biased  coin";101;422;101;321;500;501
"603";"2. Neyman known";"2. Neyman known";101;418;97;321;470;530
"604";"3. RSIHR Known";"3. RSIHR Known";101;486;79;407;361;639
"605";"4. Rosenberger known";"4. Rosenberger known";101;558;34;524;148;852
"606";"5. Optimal adjusted";"5. Optimal adjusted";101;400;107;293;525;475
"607";"1. Random";"1. Random";102;402;101;301;504;496
"608";"6. Biased  coin";"6. Biased  coin";102;394;100;294;500;500
"609";"2. Neyman known";"2. Neyman known";102;409;85;324;462;538
"610";"3. RSIHR Known";"3. RSIHR Known";102;478;66;412;329;671
"611";"4. Rosenberger known";"4. Rosenberger known";102;560;28;532;136;864
"612";"5. Optimal adjusted";"5. Optimal adjusted";102;389;104;285;522;478
"613";"1. Random";"1. Random";103;400;102;298;515;485
"614";"6. Biased  coin";"6. Biased  coin";103;419;103;316;501;500
"615";"2. Neyman known";"2. Neyman known";103;443;91;352;445;555
"616";"3. RSIHR Known";"3. RSIHR Known";103;435;65;370;390;610
"617";"4. Rosenberger known";"4. Rosenberger known";103;568;22;546;119;881
"618";"5. Optimal adjusted";"5. Optimal adjusted";103;377;110;267;566;434
"619";"1. Random";"1. Random";104;429;101;328;476;524
"620";"6. Biased  coin";"6. Biased  coin";104;383;99;284;504;498
"621";"2. Neyman known";"2. Neyman known";104;444;106;338;445;555
"622";"3. RSIHR Known";"3. RSIHR Known";104;456;72;384;375;625
"623";"4. Rosenberger known";"4. Rosenberger known";104;520;27;493;151;849
"624";"5. Optimal adjusted";"5. Optimal adjusted";104;400;104;296;524;476
"625";"1. Random";"1. Random";105;399;89;310;499;501
"626";"6. Biased  coin";"6. Biased  coin";105;383;88;295;503;500
"627";"2. Neyman known";"2. Neyman known";105;435;95;340;458;542
"628";"3. RSIHR Known";"3. RSIHR Known";105;471;65;406;325;675
"629";"4. Rosenberger known";"4. Rosenberger known";105;545;30;515;159;841
"630";"5. Optimal adjusted";"5. Optimal adjusted";105;373;105;268;542;458
"631";"1. Random";"1. Random";106;382;86;296;493;507
"632";"6. Biased  coin";"6. Biased  coin";106;394;102;292;500;500
"633";"2. Neyman known";"2. Neyman known";106;406;81;325;434;566
"634";"3. RSIHR Known";"3. RSIHR Known";106;457;72;385;366;634
"635";"4. Rosenberger known";"4. Rosenberger known";106;530;28;502;157;843
"636";"5. Optimal adjusted";"5. Optimal adjusted";106;374;96;278;542;458
"637";"1. Random";"1. Random";107;440;108;332;484;516
"638";"6. Biased  coin";"6. Biased  coin";107;419;104;315;500;500
"639";"2. Neyman known";"2. Neyman known";107;467;106;361;444;556
"640";"3. RSIHR Known";"3. RSIHR Known";107;479;67;412;333;667
"641";"4. Rosenberger known";"4. Rosenberger known";107;552;30;522;158;842
"642";"5. Optimal adjusted";"5. Optimal adjusted";107;415;113;302;509;491
"643";"1. Random";"1. Random";108;419;103;316;480;520
"644";"6. Biased  coin";"6. Biased  coin";108;416;104;312;501;500
"645";"2. Neyman known";"2. Neyman known";108;425;102;323;460;540
"646";"3. RSIHR Known";"3. RSIHR Known";108;453;80;373;364;636
"647";"4. Rosenberger known";"4. Rosenberger known";108;534;26;508;137;863
"648";"5. Optimal adjusted";"5. Optimal adjusted";108;398;121;277;540;460
"649";"1. Random";"1. Random";109;420;99;321;492;508
"650";"6. Biased  coin";"6. Biased  coin";109;414;98;316;499;502
"651";"2. Neyman known";"2. Neyman known";109;435;104;331;437;563
"652";"3. RSIHR Known";"3. RSIHR Known";109;474;91;383;392;608
"653";"4. Rosenberger known";"4. Rosenberger known";109;563;27;536;126;874
"654";"5. Optimal adjusted";"5. Optimal adjusted";109;369;106;263;556;444
"655";"1. Random";"1. Random";110;397;111;286;526;474
"656";"6. Biased  coin";"6. Biased  coin";110;421;104;317;499;501
"657";"2. Neyman known";"2. Neyman known";110;432;94;338;447;553
"658";"3. RSIHR Known";"3. RSIHR Known";110;454;84;370;390;610
"659";"4. Rosenberger known";"4. Rosenberger known";110;548;29;519;147;853
"660";"5. Optimal adjusted";"5. Optimal adjusted";110;418;118;300;526;474
"661";"1. Random";"1. Random";111;407;86;321;468;532
"662";"6. Biased  coin";"6. Biased  coin";111;402;100;302;502;500
"663";"2. Neyman known";"2. Neyman known";111;432;85;347;441;559
"664";"3. RSIHR Known";"3. RSIHR Known";111;447;75;372;376;624
"665";"4. Rosenberger known";"4. Rosenberger known";111;542;39;503;160;840
"666";"5. Optimal adjusted";"5. Optimal adjusted";111;375;105;270;548;452
"667";"1. Random";"1. Random";112;401;105;296;518;482
"668";"6. Biased  coin";"6. Biased  coin";112;397;96;301;502;499
"669";"2. Neyman known";"2. Neyman known";112;424;87;337;450;550
"670";"3. RSIHR Known";"3. RSIHR Known";112;439;76;363;381;619
"671";"4. Rosenberger known";"4. Rosenberger known";112;559;26;533;141;859
"672";"5. Optimal adjusted";"5. Optimal adjusted";112;394;100;294;537;463
"673";"1. Random";"1. Random";113;389;74;315;482;518
"674";"6. Biased  coin";"6. Biased  coin";113;372;82;290;501;500
"675";"2. Neyman known";"2. Neyman known";113;372;92;280;493;507
"676";"3. RSIHR Known";"3. RSIHR Known";113;444;58;386;348;652
"677";"4. Rosenberger known";"4. Rosenberger known";113;522;32;490;153;847
"678";"5. Optimal adjusted";"5. Optimal adjusted";113;373;94;279;510;490
"679";"1. Random";"1. Random";114;399;83;316;481;519
"680";"6. Biased  coin";"6. Biased  coin";114;392;91;301;502;500
"681";"2. Neyman known";"2. Neyman known";114;430;88;342;445;555
"682";"3. RSIHR Known";"3. RSIHR Known";114;447;65;382;361;639
"683";"4. Rosenberger known";"4. Rosenberger known";114;545;21;524;144;856
"684";"5. Optimal adjusted";"5. Optimal adjusted";114;380;104;276;541;459
"685";"1. Random";"1. Random";115;379;89;290;481;519
"686";"6. Biased  coin";"6. Biased  coin";115;397;112;285;502;499
"687";"2. Neyman known";"2. Neyman known";115;395;98;297;448;552
"688";"3. RSIHR Known";"3. RSIHR Known";115;427;64;363;358;642
"689";"4. Rosenberger known";"4. Rosenberger known";115;534;30;504;136;864
"690";"5. Optimal adjusted";"5. Optimal adjusted";115;353;114;239;556;444
"691";"1. Random";"1. Random";116;404;87;317;486;514
"692";"6. Biased  coin";"6. Biased  coin";116;405;99;306;499;502
"693";"2. Neyman known";"2. Neyman known";116;414;78;336;455;545
"694";"3. RSIHR Known";"3. RSIHR Known";116;455;71;384;383;617
"695";"4. Rosenberger known";"4. Rosenberger known";116;552;27;525;155;845
"696";"5. Optimal adjusted";"5. Optimal adjusted";116;393;107;286;551;449
"697";"1. Random";"1. Random";117;416;107;309;493;507
"698";"6. Biased  coin";"6. Biased  coin";117;400;104;296;503;500
"699";"2. Neyman known";"2. Neyman known";117;406;76;330;418;582
"700";"3. RSIHR Known";"3. RSIHR Known";117;447;73;374;365;635
"701";"4. Rosenberger known";"4. Rosenberger known";117;571;32;539;128;872
"702";"5. Optimal adjusted";"5. Optimal adjusted";117;373;115;258;566;434
"703";"1. Random";"1. Random";118;392;103;289;531;469
"704";"6. Biased  coin";"6. Biased  coin";118;409;100;309;503;499
"705";"2. Neyman known";"2. Neyman known";118;440;84;356;434;566
"706";"3. RSIHR Known";"3. RSIHR Known";118;443;71;372;374;626
"707";"4. Rosenberger known";"4. Rosenberger known";118;547;20;527;141;859
"708";"5. Optimal adjusted";"5. Optimal adjusted";118;384;104;280;535;465
"709";"1. Random";"1. Random";119;422;113;309;485;515
"710";"6. Biased  coin";"6. Biased  coin";119;393;92;301;499;501
"711";"2. Neyman known";"2. Neyman known";119;446;93;353;421;579
"712";"3. RSIHR Known";"3. RSIHR Known";119;447;73;374;380;620
"713";"4. Rosenberger known";"4. Rosenberger known";119;547;22;525;144;856
"714";"5. Optimal adjusted";"5. Optimal adjusted";119;399;109;290;540;460
"715";"1. Random";"1. Random";120;410;93;317;503;497
"716";"6. Biased  coin";"6. Biased  coin";120;377;89;288;499;501
"717";"2. Neyman known";"2. Neyman known";120;422;88;334;443;557
"718";"3. RSIHR Known";"3. RSIHR Known";120;459;56;403;349;651
"719";"4. Rosenberger known";"4. Rosenberger known";120;548;26;522;142;858
"720";"5. Optimal adjusted";"5. Optimal adjusted";120;379;96;283;539;461
"721";"1. Random";"1. Random";121;391;88;303;496;504
"722";"6. Biased  coin";"6. Biased  coin";121;391;96;295;502;499
"723";"2. Neyman known";"2. Neyman known";121;412;76;336;442;558
"724";"3. RSIHR Known";"3. RSIHR Known";121;465;62;403;340;660
"725";"4. Rosenberger known";"4. Rosenberger known";121;546;26;520;139;861
"726";"5. Optimal adjusted";"5. Optimal adjusted";121;381;96;285;514;486
"727";"1. Random";"1. Random";122;379;77;302;490;510
"728";"6. Biased  coin";"6. Biased  coin";122;386;91;295;502;499
"729";"2. Neyman known";"2. Neyman known";122;391;78;313;460;540
"730";"3. RSIHR Known";"3. RSIHR Known";122;431;53;378;350;650
"731";"4. Rosenberger known";"4. Rosenberger known";122;508;16;492;150;850
"732";"5. Optimal adjusted";"5. Optimal adjusted";122;346;99;247;553;447
"733";"1. Random";"1. Random";123;407;103;304;509;491
"734";"6. Biased  coin";"6. Biased  coin";123;395;99;296;500;500
"735";"2. Neyman known";"2. Neyman known";123;435;100;335;439;561
"736";"3. RSIHR Known";"3. RSIHR Known";123;436;69;367;383;617
"737";"4. Rosenberger known";"4. Rosenberger known";123;551;29;522;141;859
"738";"5. Optimal adjusted";"5. Optimal adjusted";123;364;108;256;561;439
"739";"1. Random";"1. Random";124;382;101;281;514;486
"740";"6. Biased  coin";"6. Biased  coin";124;390;91;299;502;499
"741";"2. Neyman known";"2. Neyman known";124;393;88;305;469;531
"742";"3. RSIHR Known";"3. RSIHR Known";124;426;71;355;371;629
"743";"4. Rosenberger known";"4. Rosenberger known";124;518;28;490;156;844
"744";"5. Optimal adjusted";"5. Optimal adjusted";124;368;98;270;543;457
"745";"1. Random";"1. Random";125;378;94;284;493;507
"746";"6. Biased  coin";"6. Biased  coin";125;394;102;292;500;500
"747";"2. Neyman known";"2. Neyman known";125;418;88;330;439;561
"748";"3. RSIHR Known";"3. RSIHR Known";125;444;81;363;383;617
"749";"4. Rosenberger known";"4. Rosenberger known";125;526;23;503;131;869
"750";"5. Optimal adjusted";"5. Optimal adjusted";125;376;110;266;556;444
"751";"1. Random";"1. Random";126;404;95;309;488;512
"752";"6. Biased  coin";"6. Biased  coin";126;423;105;318;501;500
"753";"2. Neyman known";"2. Neyman known";126;406;90;316;465;535
"754";"3. RSIHR Known";"3. RSIHR Known";126;428;69;359;392;608
"755";"4. Rosenberger known";"4. Rosenberger known";126;559;24;535;126;874
"756";"5. Optimal adjusted";"5. Optimal adjusted";126;393;106;287;524;476
"757";"1. Random";"1. Random";127;375;97;278;532;468
"758";"6. Biased  coin";"6. Biased  coin";127;398;96;302;500;500
"759";"2. Neyman known";"2. Neyman known";127;423;77;346;459;541
"760";"3. RSIHR Known";"3. RSIHR Known";127;462;67;395;365;635
"761";"4. Rosenberger known";"4. Rosenberger known";127;568;26;542;128;872
"762";"5. Optimal adjusted";"5. Optimal adjusted";127;381;106;275;541;459
"763";"1. Random";"1. Random";128;400;101;299;513;487
"764";"6. Biased  coin";"6. Biased  coin";128;422;106;316;500;500
"765";"2. Neyman known";"2. Neyman known";128;417;90;327;472;528
"766";"3. RSIHR Known";"3. RSIHR Known";128;440;68;372;391;609
"767";"4. Rosenberger known";"4. Rosenberger known";128;556;20;536;134;866
"768";"5. Optimal adjusted";"5. Optimal adjusted";128;401;104;297;518;482
"769";"1. Random";"1. Random";129;394;96;298;490;510
"770";"6. Biased  coin";"6. Biased  coin";129;398;100;298;500;500
"771";"2. Neyman known";"2. Neyman known";129;421;93;328;446;554
"772";"3. RSIHR Known";"3. RSIHR Known";129;446;66;380;353;647
"773";"4. Rosenberger known";"4. Rosenberger known";129;538;38;500;169;831
"774";"5. Optimal adjusted";"5. Optimal adjusted";129;407;104;303;514;486
"775";"1. Random";"1. Random";130;391;81;310;495;505
"776";"6. Biased  coin";"6. Biased  coin";130;409;105;304;500;500
"777";"2. Neyman known";"2. Neyman known";130;421;78;343;428;572
"778";"3. RSIHR Known";"3. RSIHR Known";130;472;78;394;364;636
"779";"4. Rosenberger known";"4. Rosenberger known";130;558;30;528;152;848
"780";"5. Optimal adjusted";"5. Optimal adjusted";130;410;110;300;531;469
"781";"1. Random";"1. Random";131;404;103;301;493;507
"782";"6. Biased  coin";"6. Biased  coin";131;409;108;301;502;500
"783";"2. Neyman known";"2. Neyman known";131;429;91;338;448;552
"784";"3. RSIHR Known";"3. RSIHR Known";131;463;73;390;340;660
"785";"4. Rosenberger known";"4. Rosenberger known";131;546;31;515;143;857
"786";"5. Optimal adjusted";"5. Optimal adjusted";131;374;105;269;543;457
"787";"1. Random";"1. Random";132;416;100;316;508;492
"788";"6. Biased  coin";"6. Biased  coin";132;399;96;303;499;501
"789";"2. Neyman known";"2. Neyman known";132;439;92;347;450;550
"790";"3. RSIHR Known";"3. RSIHR Known";132;465;79;386;388;612
"791";"4. Rosenberger known";"4. Rosenberger known";132;574;32;542;151;849
"792";"5. Optimal adjusted";"5. Optimal adjusted";132;412;114;298;547;453
"793";"1. Random";"1. Random";133;389;98;291;502;498
"794";"6. Biased  coin";"6. Biased  coin";133;403;105;298;501;500
"795";"2. Neyman known";"2. Neyman known";133;416;94;322;464;536
"796";"3. RSIHR Known";"3. RSIHR Known";133;436;67;369;375;625
"797";"4. Rosenberger known";"4. Rosenberger known";133;534;27;507;120;880
"798";"5. Optimal adjusted";"5. Optimal adjusted";133;374;102;272;520;480
"799";"1. Random";"1. Random";134;409;106;303;517;483
"800";"6. Biased  coin";"6. Biased  coin";134;425;105;320;501;500
"801";"2. Neyman known";"2. Neyman known";134;421;82;339;447;553
"802";"3. RSIHR Known";"3. RSIHR Known";134;484;75;409;364;636
"803";"4. Rosenberger known";"4. Rosenberger known";134;567;29;538;144;856
"804";"5. Optimal adjusted";"5. Optimal adjusted";134;359;96;263;570;430
"805";"1. Random";"1. Random";135;418;84;334;481;519
"806";"6. Biased  coin";"6. Biased  coin";135;403;92;311;499;501
"807";"2. Neyman known";"2. Neyman known";135;438;98;340;456;544
"808";"3. RSIHR Known";"3. RSIHR Known";135;466;77;389;377;623
"809";"4. Rosenberger known";"4. Rosenberger known";135;571;31;540;132;868
"810";"5. Optimal adjusted";"5. Optimal adjusted";135;377;100;277;539;461
"811";"1. Random";"1. Random";136;397;95;302;505;495
"812";"6. Biased  coin";"6. Biased  coin";136;400;87;313;502;501
"813";"2. Neyman known";"2. Neyman known";136;407;71;336;444;556
"814";"3. RSIHR Known";"3. RSIHR Known";136;447;67;380;369;631
"815";"4. Rosenberger known";"4. Rosenberger known";136;543;33;510;163;837
"816";"5. Optimal adjusted";"5. Optimal adjusted";136;374;93;281;519;481
"817";"1. Random";"1. Random";137;391;87;304;494;506
"818";"6. Biased  coin";"6. Biased  coin";137;391;91;300;501;500
"819";"2. Neyman known";"2. Neyman known";137;406;80;326;454;546
"820";"3. RSIHR Known";"3. RSIHR Known";137;449;67;382;370;630
"821";"4. Rosenberger known";"4. Rosenberger known";137;549;25;524;137;863
"822";"5. Optimal adjusted";"5. Optimal adjusted";137;386;103;283;550;450
"823";"1. Random";"1. Random";138;369;84;285;508;492
"824";"6. Biased  coin";"6. Biased  coin";138;378;78;300;501;500
"825";"2. Neyman known";"2. Neyman known";138;403;89;314;442;558
"826";"3. RSIHR Known";"3. RSIHR Known";138;411;63;348;385;615
"827";"4. Rosenberger known";"4. Rosenberger known";138;526;21;505;137;863
"828";"5. Optimal adjusted";"5. Optimal adjusted";138;386;97;289;519;481
"829";"1. Random";"1. Random";139;413;104;309;480;520
"830";"6. Biased  coin";"6. Biased  coin";139;395;88;307;501;500
"831";"2. Neyman known";"2. Neyman known";139;406;83;323;439;561
"832";"3. RSIHR Known";"3. RSIHR Known";139;445;72;373;384;616
"833";"4. Rosenberger known";"4. Rosenberger known";139;555;30;525;136;864
"834";"5. Optimal adjusted";"5. Optimal adjusted";139;381;95;286;518;482
"835";"1. Random";"1. Random";140;364;80;284;500;500
"836";"6. Biased  coin";"6. Biased  coin";140;408;91;317;500;500
"837";"2. Neyman known";"2. Neyman known";140;427;70;357;427;573
"838";"3. RSIHR Known";"3. RSIHR Known";140;420;59;361;376;624
"839";"4. Rosenberger known";"4. Rosenberger known";140;538;26;512;143;857
"840";"5. Optimal adjusted";"5. Optimal adjusted";140;363;94;269;535;465
"841";"1. Random";"1. Random";141;408;97;311;482;518
"842";"6. Biased  coin";"6. Biased  coin";141;364;80;284;499;501
"843";"2. Neyman known";"2. Neyman known";141;430;92;338;436;564
"844";"3. RSIHR Known";"3. RSIHR Known";141;442;69;373;369;631
"845";"4. Rosenberger known";"4. Rosenberger known";141;544;35;509;151;849
"846";"5. Optimal adjusted";"5. Optimal adjusted";141;389;103;286;518;482
"847";"1. Random";"1. Random";142;420;100;320;474;526
"848";"6. Biased  coin";"6. Biased  coin";142;432;116;316;501;500
"849";"2. Neyman known";"2. Neyman known";142;448;117;331;467;533
"850";"3. RSIHR Known";"3. RSIHR Known";142;474;80;394;356;644
"851";"4. Rosenberger known";"4. Rosenberger known";142;543;31;512;147;853
"852";"5. Optimal adjusted";"5. Optimal adjusted";142;409;118;291;533;467
"853";"1. Random";"1. Random";143;384;82;302;485;515
"854";"6. Biased  coin";"6. Biased  coin";143;388;93;295;500;500
"855";"2. Neyman known";"2. Neyman known";143;421;91;330;457;543
"856";"3. RSIHR Known";"3. RSIHR Known";143;453;70;383;352;648
"857";"4. Rosenberger known";"4. Rosenberger known";143;542;29;513;150;850
"858";"5. Optimal adjusted";"5. Optimal adjusted";143;374;95;279;532;468
"859";"1. Random";"1. Random";144;404;101;303;528;472
"860";"6. Biased  coin";"6. Biased  coin";144;387;89;298;502;500
"861";"2. Neyman known";"2. Neyman known";144;429;82;347;437;563
"862";"3. RSIHR Known";"3. RSIHR Known";144;447;72;375;387;613
"863";"4. Rosenberger known";"4. Rosenberger known";144;559;19;540;129;871
"864";"5. Optimal adjusted";"5. Optimal adjusted";144;382;105;277;515;485
"865";"1. Random";"1. Random";145;397;92;305;506;494
"866";"6. Biased  coin";"6. Biased  coin";145;393;96;297;502;499
"867";"2. Neyman known";"2. Neyman known";145;389;84;305;472;528
"868";"3. RSIHR Known";"3. RSIHR Known";145;443;68;375;381;619
"869";"4. Rosenberger known";"4. Rosenberger known";145;540;25;515;145;855
"870";"5. Optimal adjusted";"5. Optimal adjusted";145;391;103;288;543;457
"871";"1. Random";"1. Random";146;410;100;310;495;505
"872";"6. Biased  coin";"6. Biased  coin";146;422;118;304;502;499
"873";"2. Neyman known";"2. Neyman known";146;415;93;322;461;539
"874";"3. RSIHR Known";"3. RSIHR Known";146;465;88;377;381;619
"875";"4. Rosenberger known";"4. Rosenberger known";146;552;36;516;146;854
"876";"5. Optimal adjusted";"5. Optimal adjusted";146;405;121;284;528;472
"877";"1. Random";"1. Random";147;419;93;326;473;527
"878";"6. Biased  coin";"6. Biased  coin";147;402;103;299;500;500
"879";"2. Neyman known";"2. Neyman known";147;430;98;332;459;541
"880";"3. RSIHR Known";"3. RSIHR Known";147;454;70;384;359;641
"881";"4. Rosenberger known";"4. Rosenberger known";147;535;30;505;151;849
"882";"5. Optimal adjusted";"5. Optimal adjusted";147;400;100;300;502;498
"883";"1. Random";"1. Random";148;404;103;301;506;494
"884";"6. Biased  coin";"6. Biased  coin";148;427;115;312;502;500
"885";"2. Neyman known";"2. Neyman known";148;400;97;303;475;525
"886";"3. RSIHR Known";"3. RSIHR Known";148;446;79;367;379;621
"887";"4. Rosenberger known";"4. Rosenberger known";148;544;32;512;158;842
"888";"5. Optimal adjusted";"5. Optimal adjusted";148;408;114;294;521;479
"889";"1. Random";"1. Random";149;407;108;299;499;501
"890";"6. Biased  coin";"6. Biased  coin";149;417;108;309;500;500
"891";"2. Neyman known";"2. Neyman known";149;416;98;318;465;535
"892";"3. RSIHR Known";"3. RSIHR Known";149;467;79;388;351;649
"893";"4. Rosenberger known";"4. Rosenberger known";149;534;33;501;158;842
"894";"5. Optimal adjusted";"5. Optimal adjusted";149;383;104;279;523;477
"895";"1. Random";"1. Random";150;392;93;299;505;495
"896";"6. Biased  coin";"6. Biased  coin";150;416;118;298;501;499
"897";"2. Neyman known";"2. Neyman known";150;419;94;325;458;542
"898";"3. RSIHR Known";"3. RSIHR Known";150;439;83;356;412;588
"899";"4. Rosenberger known";"4. Rosenberger known";150;554;28;526;125;875
"900";"5. Optimal adjusted";"5. Optimal adjusted";150;382;108;274;540;460
"901";"1. Random";"1. Random";151;386;90;296;498;502
"902";"6. Biased  coin";"6. Biased  coin";151;395;92;303;503;499
"903";"2. Neyman known";"2. Neyman known";151;428;78;350;439;561
"904";"3. RSIHR Known";"3. RSIHR Known";151;467;79;388;363;637
"905";"4. Rosenberger known";"4. Rosenberger known";151;546;21;525;136;864
"906";"5. Optimal adjusted";"5. Optimal adjusted";151;378;91;287;520;480
"907";"1. Random";"1. Random";152;378;93;285;512;488
"908";"6. Biased  coin";"6. Biased  coin";152;406;103;303;500;500
"909";"2. Neyman known";"2. Neyman known";152;429;92;337;465;535
"910";"3. RSIHR Known";"3. RSIHR Known";152;440;64;376;369;631
"911";"4. Rosenberger known";"4. Rosenberger known";152;527;22;505;140;860
"912";"5. Optimal adjusted";"5. Optimal adjusted";152;361;104;257;573;427
"913";"1. Random";"1. Random";153;376;101;275;521;479
"914";"6. Biased  coin";"6. Biased  coin";153;405;91;314;501;500
"915";"2. Neyman known";"2. Neyman known";153;436;91;345;447;553
"916";"3. RSIHR Known";"3. RSIHR Known";153;461;59;402;343;657
"917";"4. Rosenberger known";"4. Rosenberger known";153;532;25;507;158;842
"918";"5. Optimal adjusted";"5. Optimal adjusted";153;391;110;281;534;466
"919";"1. Random";"1. Random";154;404;97;307;487;513
"920";"6. Biased  coin";"6. Biased  coin";154;402;111;291;499;501
"921";"2. Neyman known";"2. Neyman known";154;427;96;331;442;558
"922";"3. RSIHR Known";"3. RSIHR Known";154;462;84;378;373;627
"923";"4. Rosenberger known";"4. Rosenberger known";154;534;23;511;139;861
"924";"5. Optimal adjusted";"5. Optimal adjusted";154;370;109;261;533;467
"925";"1. Random";"1. Random";155;417;115;302;502;498
"926";"6. Biased  coin";"6. Biased  coin";155;408;109;299;501;500
"927";"2. Neyman known";"2. Neyman known";155;427;99;328;456;544
"928";"3. RSIHR Known";"3. RSIHR Known";155;455;91;364;396;604
"929";"4. Rosenberger known";"4. Rosenberger known";155;531;30;501;162;838
"930";"5. Optimal adjusted";"5. Optimal adjusted";155;379;111;268;558;442
"931";"1. Random";"1. Random";156;399;101;298;513;487
"932";"6. Biased  coin";"6. Biased  coin";156;403;97;306;500;500
"933";"2. Neyman known";"2. Neyman known";156;424;78;346;401;599
"934";"3. RSIHR Known";"3. RSIHR Known";156;432;65;367;379;621
"935";"4. Rosenberger known";"4. Rosenberger known";156;514;18;496;148;852
"936";"5. Optimal adjusted";"5. Optimal adjusted";156;389;102;287;508;492
"937";"1. Random";"1. Random";157;400;106;294;512;488
"938";"6. Biased  coin";"6. Biased  coin";157;394;96;298;500;500
"939";"2. Neyman known";"2. Neyman known";157;422;97;325;470;530
"940";"3. RSIHR Known";"3. RSIHR Known";157;431;71;360;360;640
"941";"4. Rosenberger known";"4. Rosenberger known";157;527;23;504;137;863
"942";"5. Optimal adjusted";"5. Optimal adjusted";157;383;121;262;545;455
"943";"1. Random";"1. Random";158;400;107;293;503;497
"944";"6. Biased  coin";"6. Biased  coin";158;412;100;312;500;500
"945";"2. Neyman known";"2. Neyman known";158;432;103;329;453;547
"946";"3. RSIHR Known";"3. RSIHR Known";158;458;68;390;348;652
"947";"4. Rosenberger known";"4. Rosenberger known";158;556;29;527;123;877
"948";"5. Optimal adjusted";"5. Optimal adjusted";158;393;103;290;514;486
"949";"1. Random";"1. Random";159;397;99;298;491;509
"950";"6. Biased  coin";"6. Biased  coin";159;402;101;301;502;499
"951";"2. Neyman known";"2. Neyman known";159;398;93;305;475;525
"952";"3. RSIHR Known";"3. RSIHR Known";159;447;73;374;371;629
"953";"4. Rosenberger known";"4. Rosenberger known";159;538;28;510;147;853
"954";"5. Optimal adjusted";"5. Optimal adjusted";159;374;103;271;534;466
"955";"1. Random";"1. Random";160;400;102;298;493;507
"956";"6. Biased  coin";"6. Biased  coin";160;414;98;316;501;499
"957";"2. Neyman known";"2. Neyman known";160;438;96;342;461;539
"958";"3. RSIHR Known";"3. RSIHR Known";160;463;70;393;369;631
"959";"4. Rosenberger known";"4. Rosenberger known";160;561;36;525;156;844
"960";"5. Optimal adjusted";"5. Optimal adjusted";160;395;107;288;526;474
"961";"1. Random";"1. Random";161;395;86;309;468;532
"962";"6. Biased  coin";"6. Biased  coin";161;404;103;301;500;500
"963";"2. Neyman known";"2. Neyman known";161;422;86;336;401;599
"964";"3. RSIHR Known";"3. RSIHR Known";161;436;80;356;379;621
"965";"4. Rosenberger known";"4. Rosenberger known";161;527;28;499;141;859
"966";"5. Optimal adjusted";"5. Optimal adjusted";161;378;117;261;545;455
"967";"1. Random";"1. Random";162;388;93;295;489;511
"968";"6. Biased  coin";"6. Biased  coin";162;385;100;285;503;500
"969";"2. Neyman known";"2. Neyman known";162;401;80;321;440;560
"970";"3. RSIHR Known";"3. RSIHR Known";162;443;71;372;377;623
"971";"4. Rosenberger known";"4. Rosenberger known";162;537;26;511;141;859
"972";"5. Optimal adjusted";"5. Optimal adjusted";162;362;95;267;532;468
"973";"1. Random";"1. Random";163;385;102;283;515;485
"974";"6. Biased  coin";"6. Biased  coin";163;393;101;292;501;499
"975";"2. Neyman known";"2. Neyman known";163;420;95;325;485;515
"976";"3. RSIHR Known";"3. RSIHR Known";163;445;78;367;384;616
"977";"4. Rosenberger known";"4. Rosenberger known";163;548;24;524;127;873
"978";"5. Optimal adjusted";"5. Optimal adjusted";163;393;105;288;531;469
"979";"1. Random";"1. Random";164;411;90;321;473;527
"980";"6. Biased  coin";"6. Biased  coin";164;409;111;298;500;500
"981";"2. Neyman known";"2. Neyman known";164;434;98;336;446;554
"982";"3. RSIHR Known";"3. RSIHR Known";164;446;69;377;369;631
"983";"4. Rosenberger known";"4. Rosenberger known";164;540;22;518;134;866
"984";"5. Optimal adjusted";"5. Optimal adjusted";164;395;107;288;539;461
"985";"1. Random";"1. Random";165;416;106;310;487;513
"986";"6. Biased  coin";"6. Biased  coin";165;399;102;297;500;500
"987";"2. Neyman known";"2. Neyman known";165;430;89;341;434;566
"988";"3. RSIHR Known";"3. RSIHR Known";165;447;75;372;377;623
"989";"4. Rosenberger known";"4. Rosenberger known";165;543;33;510;136;864
"990";"5. Optimal adjusted";"5. Optimal adjusted";165;391;125;266;573;427
"991";"1. Random";"1. Random";166;404;77;327;450;550
"992";"6. Biased  coin";"6. Biased  coin";166;389;84;305;500;500
"993";"2. Neyman known";"2. Neyman known";166;443;92;351;432;568
"994";"3. RSIHR Known";"3. RSIHR Known";166;451;73;378;380;620
"995";"4. Rosenberger known";"4. Rosenberger known";166;556;21;535;121;879
"996";"5. Optimal adjusted";"5. Optimal adjusted";166;366;97;269;542;458
"997";"1. Random";"1. Random";167;382;87;295;495;505
"998";"6. Biased  coin";"6. Biased  coin";167;406;101;305;502;500
"999";"2. Neyman known";"2. Neyman known";167;424;88;336;450;550
"1000";"3. RSIHR Known";"3. RSIHR Known";167;456;63;393;348;652
"1001";"4. Rosenberger known";"4. Rosenberger known";167;540;32;508;156;844
"1002";"5. Optimal adjusted";"5. Optimal adjusted";167;368;103;265;551;449
"1003";"1. Random";"1. Random";168;397;77;320;487;513
"1004";"6. Biased  coin";"6. Biased  coin";168;375;79;296;502;499
"1005";"2. Neyman known";"2. Neyman known";168;411;80;331;449;551
"1006";"3. RSIHR Known";"3. RSIHR Known";168;452;65;387;356;644
"1007";"4. Rosenberger known";"4. Rosenberger known";168;547;21;526;132;868
"1008";"5. Optimal adjusted";"5. Optimal adjusted";168;395;91;304;512;488
"1009";"1. Random";"1. Random";169;398;89;309;478;522
"1010";"6. Biased  coin";"6. Biased  coin";169;371;91;280;498;502
"1011";"2. Neyman known";"2. Neyman known";169;424;94;330;440;560
"1012";"3. RSIHR Known";"3. RSIHR Known";169;441;76;365;378;622
"1013";"4. Rosenberger known";"4. Rosenberger known";169;533;26;507;133;867
"1014";"5. Optimal adjusted";"5. Optimal adjusted";169;397;109;288;508;492
"1015";"1. Random";"1. Random";170;392;99;293;510;490
"1016";"6. Biased  coin";"6. Biased  coin";170;383;95;288;500;500
"1017";"2. Neyman known";"2. Neyman known";170;418;84;334;453;547
"1018";"3. RSIHR Known";"3. RSIHR Known";170;462;70;392;369;631
"1019";"4. Rosenberger known";"4. Rosenberger known";170;540;28;512;160;840
"1020";"5. Optimal adjusted";"5. Optimal adjusted";170;400;102;298;513;487
"1021";"1. Random";"1. Random";171;387;99;288;479;521
"1022";"6. Biased  coin";"6. Biased  coin";171;390;92;298;502;500
"1023";"2. Neyman known";"2. Neyman known";171;389;89;300;467;533
"1024";"3. RSIHR Known";"3. RSIHR Known";171;428;59;369;370;630
"1025";"4. Rosenberger known";"4. Rosenberger known";171;525;25;500;139;861
"1026";"5. Optimal adjusted";"5. Optimal adjusted";171;358;111;247;556;444
"1027";"1. Random";"1. Random";172;398;86;312;479;521
"1028";"6. Biased  coin";"6. Biased  coin";172;385;92;293;500;500
"1029";"2. Neyman known";"2. Neyman known";172;430;80;350;451;549
"1030";"3. RSIHR Known";"3. RSIHR Known";172;465;64;401;355;645
"1031";"4. Rosenberger known";"4. Rosenberger known";172;554;29;525;147;853
"1032";"5. Optimal adjusted";"5. Optimal adjusted";172;389;111;278;552;448
"1033";"1. Random";"1. Random";173;396;99;297;496;504
"1034";"6. Biased  coin";"6. Biased  coin";173;395;94;301;500;500
"1035";"2. Neyman known";"2. Neyman known";173;403;87;316;469;531
"1036";"3. RSIHR Known";"3. RSIHR Known";173;465;71;394;357;643
"1037";"4. Rosenberger known";"4. Rosenberger known";173;551;25;526;132;868
"1038";"5. Optimal adjusted";"5. Optimal adjusted";173;403;106;297;517;483
"1039";"1. Random";"1. Random";174;421;102;319;480;520
"1040";"6. Biased  coin";"6. Biased  coin";174;393;96;297;499;502
"1041";"2. Neyman known";"2. Neyman known";174;408;84;324;451;549
"1042";"3. RSIHR Known";"3. RSIHR Known";174;457;80;377;374;626
"1043";"4. Rosenberger known";"4. Rosenberger known";174;550;22;528;136;864
"1044";"5. Optimal adjusted";"5. Optimal adjusted";174;400;110;290;533;467
"1045";"1. Random";"1. Random";175;398;98;300;508;492
"1046";"6. Biased  coin";"6. Biased  coin";175;407;100;307;501;499
"1047";"2. Neyman known";"2. Neyman known";175;446;100;346;428;572
"1048";"3. RSIHR Known";"3. RSIHR Known";175;451;65;386;385;615
"1049";"4. Rosenberger known";"4. Rosenberger known";175;561;22;539;121;879
"1050";"5. Optimal adjusted";"5. Optimal adjusted";175;392;103;289;526;474
"1051";"1. Random";"1. Random";176;395;117;278;526;474
"1052";"6. Biased  coin";"6. Biased  coin";176;407;109;298;500;501
"1053";"2. Neyman known";"2. Neyman known";176;420;84;336;436;564
"1054";"3. RSIHR Known";"3. RSIHR Known";176;451;71;380;339;661
"1055";"4. Rosenberger known";"4. Rosenberger known";176;537;27;510;148;852
"1056";"5. Optimal adjusted";"5. Optimal adjusted";176;373;101;272;547;453
"1057";"1. Random";"1. Random";177;424;105;319;488;512
"1058";"6. Biased  coin";"6. Biased  coin";177;421;103;318;501;500
"1059";"2. Neyman known";"2. Neyman known";177;447;108;339;469;531
"1060";"3. RSIHR Known";"3. RSIHR Known";177;477;78;399;358;642
"1061";"4. Rosenberger known";"4. Rosenberger known";177;588;34;554;132;868
"1062";"5. Optimal adjusted";"5. Optimal adjusted";177;393;109;284;556;444
"1063";"1. Random";"1. Random";178;414;101;313;497;503
"1064";"6. Biased  coin";"6. Biased  coin";178;404;98;306;500;500
"1065";"2. Neyman known";"2. Neyman known";178;443;91;352;446;554
"1066";"3. RSIHR Known";"3. RSIHR Known";178;453;61;392;359;641
"1067";"4. Rosenberger known";"4. Rosenberger known";178;541;20;521;156;844
"1068";"5. Optimal adjusted";"5. Optimal adjusted";178;397;113;284;565;435
"1069";"1. Random";"1. Random";179;393;94;299;490;510
"1070";"6. Biased  coin";"6. Biased  coin";179;381;98;283;501;499
"1071";"2. Neyman known";"2. Neyman known";179;426;85;341;435;565
"1072";"3. RSIHR Known";"3. RSIHR Known";179;462;80;382;346;654
"1073";"4. Rosenberger known";"4. Rosenberger known";179;531;21;510;133;867
"1074";"5. Optimal adjusted";"5. Optimal adjusted";179;375;105;270;558;442
"1075";"1. Random";"1. Random";180;386;97;289;520;480
"1076";"6. Biased  coin";"6. Biased  coin";180;415;100;315;501;501
"1077";"2. Neyman known";"2. Neyman known";180;434;87;347;448;552
"1078";"3. RSIHR Known";"3. RSIHR Known";180;421;67;354;403;597
"1079";"4. Rosenberger known";"4. Rosenberger known";180;546;26;520;145;855
"1080";"5. Optimal adjusted";"5. Optimal adjusted";180;382;107;275;544;456
"1081";"1. Random";"1. Random";181;374;95;279;514;486
"1082";"6. Biased  coin";"6. Biased  coin";181;397;110;287;500;500
"1083";"2. Neyman known";"2. Neyman known";181;405;70;335;416;584
"1084";"3. RSIHR Known";"3. RSIHR Known";181;443;77;366;367;633
"1085";"4. Rosenberger known";"4. Rosenberger known";181;528;30;498;147;853
"1086";"5. Optimal adjusted";"5. Optimal adjusted";181;372;99;273;514;486
"1087";"1. Random";"1. Random";182;402;107;295;493;507
"1088";"6. Biased  coin";"6. Biased  coin";182;396;103;293;504;499
"1089";"2. Neyman known";"2. Neyman known";182;436;86;350;422;578
"1090";"3. RSIHR Known";"3. RSIHR Known";182;454;86;368;381;619
"1091";"4. Rosenberger known";"4. Rosenberger known";182;546;38;508;146;854
"1092";"5. Optimal adjusted";"5. Optimal adjusted";182;378;106;272;520;480
"1093";"1. Random";"1. Random";183;404;87;317;497;503
"1094";"6. Biased  coin";"6. Biased  coin";183;415;107;308;501;499
"1095";"2. Neyman known";"2. Neyman known";183;399;86;313;471;529
"1096";"3. RSIHR Known";"3. RSIHR Known";183;476;64;412;328;672
"1097";"4. Rosenberger known";"4. Rosenberger known";183;550;28;522;146;854
"1098";"5. Optimal adjusted";"5. Optimal adjusted";183;380;114;266;562;438
"1099";"1. Random";"1. Random";184;404;98;306;502;498
"1100";"6. Biased  coin";"6. Biased  coin";184;413;110;303;500;501
"1101";"2. Neyman known";"2. Neyman known";184;445;101;344;446;554
"1102";"3. RSIHR Known";"3. RSIHR Known";184;449;82;367;387;613
"1103";"4. Rosenberger known";"4. Rosenberger known";184;556;30;526;127;873
"1104";"5. Optimal adjusted";"5. Optimal adjusted";184;400;109;291;506;494
"1105";"1. Random";"1. Random";185;385;80;305;524;476
"1106";"6. Biased  coin";"6. Biased  coin";185;405;87;318;499;501
"1107";"2. Neyman known";"2. Neyman known";185;399;77;322;461;539
"1108";"3. RSIHR Known";"3. RSIHR Known";185;452;54;398;365;635
"1109";"4. Rosenberger known";"4. Rosenberger known";185;567;25;542;124;876
"1110";"5. Optimal adjusted";"5. Optimal adjusted";185;396;89;307;504;496
"1111";"1. Random";"1. Random";186;414;102;312;484;516
"1112";"6. Biased  coin";"6. Biased  coin";186;386;84;302;503;500
"1113";"2. Neyman known";"2. Neyman known";186;434;88;346;432;568
"1114";"3. RSIHR Known";"3. RSIHR Known";186;465;74;391;366;634
"1115";"4. Rosenberger known";"4. Rosenberger known";186;553;23;530;134;866
"1116";"5. Optimal adjusted";"5. Optimal adjusted";186;391;115;276;549;451
"1117";"1. Random";"1. Random";187;402;93;309;469;531
"1118";"6. Biased  coin";"6. Biased  coin";187;386;99;287;499;501
"1119";"2. Neyman known";"2. Neyman known";187;417;97;320;460;540
"1120";"3. RSIHR Known";"3. RSIHR Known";187;437;66;371;362;638
"1121";"4. Rosenberger known";"4. Rosenberger known";187;526;30;496;144;856
"1122";"5. Optimal adjusted";"5. Optimal adjusted";187;376;112;264;548;452
"1123";"1. Random";"1. Random";188;401;103;298;515;485
"1124";"6. Biased  coin";"6. Biased  coin";188;408;109;299;501;499
"1125";"2. Neyman known";"2. Neyman known";188;433;91;342;441;559
"1126";"3. RSIHR Known";"3. RSIHR Known";188;457;66;391;351;649
"1127";"4. Rosenberger known";"4. Rosenberger known";188;544;24;520;145;855
"1128";"5. Optimal adjusted";"5. Optimal adjusted";188;380;109;271;550;450
"1129";"1. Random";"1. Random";189;396;112;284;525;475
"1130";"6. Biased  coin";"6. Biased  coin";189;390;87;303;502;500
"1131";"2. Neyman known";"2. Neyman known";189;413;72;341;431;569
"1132";"3. RSIHR Known";"3. RSIHR Known";189;455;67;388;350;650
"1133";"4. Rosenberger known";"4. Rosenberger known";189;538;26;512;148;852
"1134";"5. Optimal adjusted";"5. Optimal adjusted";189;388;95;293;514;486
"1135";"1. Random";"1. Random";190;393;97;296;512;488
"1136";"6. Biased  coin";"6. Biased  coin";190;378;89;289;500;500
"1137";"2. Neyman known";"2. Neyman known";190;414;81;333;444;556
"1138";"3. RSIHR Known";"3. RSIHR Known";190;436;68;368;372;628
"1139";"4. Rosenberger known";"4. Rosenberger known";190;533;29;504;145;855
"1140";"5. Optimal adjusted";"5. Optimal adjusted";190;392;104;288;535;465
"1141";"1. Random";"1. Random";191;414;108;306;517;483
"1142";"6. Biased  coin";"6. Biased  coin";191;411;102;309;500;500
"1143";"2. Neyman known";"2. Neyman known";191;451;90;361;436;564
"1144";"3. RSIHR Known";"3. RSIHR Known";191;477;80;397;360;640
"1145";"4. Rosenberger known";"4. Rosenberger known";191;569;25;544;124;876
"1146";"5. Optimal adjusted";"5. Optimal adjusted";191;419;121;298;536;464
"1147";"1. Random";"1. Random";192;393;103;290;508;492
"1148";"6. Biased  coin";"6. Biased  coin";192;434;112;322;498;502
"1149";"2. Neyman known";"2. Neyman known";192;418;94;324;445;555
"1150";"3. RSIHR Known";"3. RSIHR Known";192;460;89;371;380;620
"1151";"4. Rosenberger known";"4. Rosenberger known";192;533;21;512;142;858
"1152";"5. Optimal adjusted";"5. Optimal adjusted";192;381;99;282;520;480
"1153";"1. Random";"1. Random";193;389;89;300;522;478
"1154";"6. Biased  coin";"6. Biased  coin";193;413;100;313;500;500
"1155";"2. Neyman known";"2. Neyman known";193;433;92;341;468;532
"1156";"3. RSIHR Known";"3. RSIHR Known";193;469;79;390;386;614
"1157";"4. Rosenberger known";"4. Rosenberger known";193;544;29;515;147;853
"1158";"5. Optimal adjusted";"5. Optimal adjusted";193;393;98;295;536;464
"1159";"1. Random";"1. Random";194;404;102;302;513;487
"1160";"6. Biased  coin";"6. Biased  coin";194;394;97;297;501;499
"1161";"2. Neyman known";"2. Neyman known";194;411;88;323;449;551
"1162";"3. RSIHR Known";"3. RSIHR Known";194;455;80;375;361;639
"1163";"4. Rosenberger known";"4. Rosenberger known";194;561;31;530;123;877
"1164";"5. Optimal adjusted";"5. Optimal adjusted";194;389;121;268;541;459
"1165";"1. Random";"1. Random";195;398;93;305;502;498
"1166";"6. Biased  coin";"6. Biased  coin";195;385;89;296;501;500
"1167";"2. Neyman known";"2. Neyman known";195;437;100;337;454;546
"1168";"3. RSIHR Known";"3. RSIHR Known";195;470;65;405;335;665
"1169";"4. Rosenberger known";"4. Rosenberger known";195;544;30;514;167;833
"1170";"5. Optimal adjusted";"5. Optimal adjusted";195;378;99;279;529;471
"1171";"1. Random";"1. Random";196;399;106;293;513;487
"1172";"6. Biased  coin";"6. Biased  coin";196;407;105;302;502;499
"1173";"2. Neyman known";"2. Neyman known";196;439;100;339;447;553
"1174";"3. RSIHR Known";"3. RSIHR Known";196;460;81;379;374;626
"1175";"4. Rosenberger known";"4. Rosenberger known";196;540;34;506;157;843
"1176";"5. Optimal adjusted";"5. Optimal adjusted";196;427;113;314;500;500
"1177";"1. Random";"1. Random";197;404;95;309;516;484
"1178";"6. Biased  coin";"6. Biased  coin";197;398;85;313;500;500
"1179";"2. Neyman known";"2. Neyman known";197;414;82;332;468;532
"1180";"3. RSIHR Known";"3. RSIHR Known";197;456;60;396;377;623
"1181";"4. Rosenberger known";"4. Rosenberger known";197;570;24;546;146;854
"1182";"5. Optimal adjusted";"5. Optimal adjusted";197;399;96;303;533;467
"1183";"1. Random";"1. Random";198;384;102;282;525;475
"1184";"6. Biased  coin";"6. Biased  coin";198;398;94;304;500;500
"1185";"2. Neyman known";"2. Neyman known";198;393;88;305;468;532
"1186";"3. RSIHR Known";"3. RSIHR Known";198;449;78;371;384;616
"1187";"4. Rosenberger known";"4. Rosenberger known";198;549;32;517;163;837
"1188";"5. Optimal adjusted";"5. Optimal adjusted";198;370;96;274;536;464
"1189";"1. Random";"1. Random";199;407;91;316;487;513
"1190";"6. Biased  coin";"6. Biased  coin";199;410;99;311;500;500
"1191";"2. Neyman known";"2. Neyman known";199;457;84;373;433;567
"1192";"3. RSIHR Known";"3. RSIHR Known";199;449;77;372;380;620
"1193";"4. Rosenberger known";"4. Rosenberger known";199;560;22;538;133;867
"1194";"5. Optimal adjusted";"5. Optimal adjusted";199;394;109;285;528;472
"1195";"1. Random";"1. Random";200;397;101;296;511;489
"1196";"6. Biased  coin";"6. Biased  coin";200;423;108;315;501;500
"1197";"2. Neyman known";"2. Neyman known";200;437;109;328;480;520
"1198";"3. RSIHR Known";"3. RSIHR Known";200;468;75;393;354;646
"1199";"4. Rosenberger known";"4. Rosenberger known";200;550;26;524;138;862
"1200";"5. Optimal adjusted";"5. Optimal adjusted";200;392;108;284;541;459
"1201";"1. Random";"1. Random";201;377;92;285;492;508
"1202";"6. Biased  coin";"6. Biased  coin";201;379;96;283;500;500
"1203";"2. Neyman known";"2. Neyman known";201;409;96;313;450;550
"1204";"3. RSIHR Known";"3. RSIHR Known";201;435;71;364;384;616
"1205";"4. Rosenberger known";"4. Rosenberger known";201;546;29;517;129;871
"1206";"5. Optimal adjusted";"5. Optimal adjusted";201;394;117;277;543;457
"1207";"1. Random";"1. Random";202;406;99;307;482;518
"1208";"6. Biased  coin";"6. Biased  coin";202;409;103;306;501;500
"1209";"2. Neyman known";"2. Neyman known";202;430;98;332;450;550
"1210";"3. RSIHR Known";"3. RSIHR Known";202;457;74;383;360;640
"1211";"4. Rosenberger known";"4. Rosenberger known";202;536;29;507;148;852
"1212";"5. Optimal adjusted";"5. Optimal adjusted";202;393;109;284;530;470
"1213";"1. Random";"1. Random";203;379;100;279;545;455
"1214";"6. Biased  coin";"6. Biased  coin";203;426;105;321;500;500
"1215";"2. Neyman known";"2. Neyman known";203;432;88;344;449;551
"1216";"3. RSIHR Known";"3. RSIHR Known";203;456;73;383;376;624
"1217";"4. Rosenberger known";"4. Rosenberger known";203;558;23;535;133;867
"1218";"5. Optimal adjusted";"5. Optimal adjusted";203;373;99;274;548;452
"1219";"1. Random";"1. Random";204;394;91;303;478;522
"1220";"6. Biased  coin";"6. Biased  coin";204;397;88;309;500;500
"1221";"2. Neyman known";"2. Neyman known";204;404;88;316;472;528
"1222";"3. RSIHR Known";"3. RSIHR Known";204;453;62;391;371;629
"1223";"4. Rosenberger known";"4. Rosenberger known";204;543;23;520;149;851
"1224";"5. Optimal adjusted";"5. Optimal adjusted";204;365;91;274;524;476
"1225";"1. Random";"1. Random";205;375;92;283;526;474
"1226";"6. Biased  coin";"6. Biased  coin";205;401;96;305;500;500
"1227";"2. Neyman known";"2. Neyman known";205;413;89;324;453;547
"1228";"3. RSIHR Known";"3. RSIHR Known";205;446;78;368;387;613
"1229";"4. Rosenberger known";"4. Rosenberger known";205;540;37;503;160;840
"1230";"5. Optimal adjusted";"5. Optimal adjusted";205;396;115;281;531;469
"1231";"1. Random";"1. Random";206;400;103;297;521;479
"1232";"6. Biased  coin";"6. Biased  coin";206;403;99;304;500;500
"1233";"2. Neyman known";"2. Neyman known";206;411;80;331;443;557
"1234";"3. RSIHR Known";"3. RSIHR Known";206;465;71;394;361;639
"1235";"4. Rosenberger known";"4. Rosenberger known";206;540;29;511;142;858
"1236";"5. Optimal adjusted";"5. Optimal adjusted";206;380;111;269;548;452
"1237";"1. Random";"1. Random";207;402;109;293;522;478
"1238";"6. Biased  coin";"6. Biased  coin";207;408;106;302;501;499
"1239";"2. Neyman known";"2. Neyman known";207;432;95;337;451;549
"1240";"3. RSIHR Known";"3. RSIHR Known";207;472;70;402;356;644
"1241";"4. Rosenberger known";"4. Rosenberger known";207;567;20;547;120;880
"1242";"5. Optimal adjusted";"5. Optimal adjusted";207;402;108;294;543;457
"1243";"1. Random";"1. Random";208;398;86;312;496;504
"1244";"6. Biased  coin";"6. Biased  coin";208;400;83;317;499;501
"1245";"2. Neyman known";"2. Neyman known";208;392;78;314;467;533
"1246";"3. RSIHR Known";"3. RSIHR Known";208;453;67;386;373;627
"1247";"4. Rosenberger known";"4. Rosenberger known";208;534;20;514;145;855
"1248";"5. Optimal adjusted";"5. Optimal adjusted";208;393;95;298;517;483
"1249";"1. Random";"1. Random";209;387;94;293;514;486
"1250";"6. Biased  coin";"6. Biased  coin";209;424;106;318;498;502
"1251";"2. Neyman known";"2. Neyman known";209;440;94;346;449;551
"1252";"3. RSIHR Known";"3. RSIHR Known";209;446;72;374;381;619
"1253";"4. Rosenberger known";"4. Rosenberger known";209;555;27;528;140;860
"1254";"5. Optimal adjusted";"5. Optimal adjusted";209;393;94;299;508;492
"1255";"1. Random";"1. Random";210;408;100;308;495;505
"1256";"6. Biased  coin";"6. Biased  coin";210;413;111;302;501;499
"1257";"2. Neyman known";"2. Neyman known";210;426;96;330;459;541
"1258";"3. RSIHR Known";"3. RSIHR Known";210;470;79;391;361;639
"1259";"4. Rosenberger known";"4. Rosenberger known";210;540;31;509;159;841
"1260";"5. Optimal adjusted";"5. Optimal adjusted";210;379;106;273;559;441
"1261";"1. Random";"1. Random";211;400;91;309;491;509
"1262";"6. Biased  coin";"6. Biased  coin";211;409;107;302;500;500
"1263";"2. Neyman known";"2. Neyman known";211;414;73;341;424;576
"1264";"3. RSIHR Known";"3. RSIHR Known";211;457;71;386;351;649
"1265";"4. Rosenberger known";"4. Rosenberger known";211;545;25;520;134;866
"1266";"5. Optimal adjusted";"5. Optimal adjusted";211;393;104;289;523;477
"1267";"1. Random";"1. Random";212;380;92;288;515;485
"1268";"6. Biased  coin";"6. Biased  coin";212;389;81;308;500;500
"1269";"2. Neyman known";"2. Neyman known";212;391;75;316;475;525
"1270";"3. RSIHR Known";"3. RSIHR Known";212;456;65;391;345;655
"1271";"4. Rosenberger known";"4. Rosenberger known";212;521;24;497;148;852
"1272";"5. Optimal adjusted";"5. Optimal adjusted";212;365;91;274;535;465
"1273";"1. Random";"1. Random";213;400;111;289;499;501
"1274";"6. Biased  coin";"6. Biased  coin";213;403;106;297;500;500
"1275";"2. Neyman known";"2. Neyman known";213;418;95;323;456;544
"1276";"3. RSIHR Known";"3. RSIHR Known";213;444;66;378;371;629
"1277";"4. Rosenberger known";"4. Rosenberger known";213;517;32;485;171;829
"1278";"5. Optimal adjusted";"5. Optimal adjusted";213;378;109;269;542;458
"1279";"1. Random";"1. Random";214;396;105;291;519;481
"1280";"6. Biased  coin";"6. Biased  coin";214;391;93;298;499;502
"1281";"2. Neyman known";"2. Neyman known";214;403;81;322;454;546
"1282";"3. RSIHR Known";"3. RSIHR Known";214;455;70;385;354;646
"1283";"4. Rosenberger known";"4. Rosenberger known";214;522;20;502;148;852
"1284";"5. Optimal adjusted";"5. Optimal adjusted";214;395;101;294;532;468
"1285";"1. Random";"1. Random";215;402;98;304;510;490
"1286";"6. Biased  coin";"6. Biased  coin";215;412;91;321;502;498
"1287";"2. Neyman known";"2. Neyman known";215;418;87;331;458;542
"1288";"3. RSIHR Known";"3. RSIHR Known";215;486;81;405;360;640
"1289";"4. Rosenberger known";"4. Rosenberger known";215;557;27;530;138;862
"1290";"5. Optimal adjusted";"5. Optimal adjusted";215;380;111;269;558;442
"1291";"1. Random";"1. Random";216;418;123;295;495;505
"1292";"6. Biased  coin";"6. Biased  coin";216;429;116;313;501;501
"1293";"2. Neyman known";"2. Neyman known";216;440;99;341;441;559
"1294";"3. RSIHR Known";"3. RSIHR Known";216;475;76;399;360;640
"1295";"4. Rosenberger known";"4. Rosenberger known";216;551;33;518;142;858
"1296";"5. Optimal adjusted";"5. Optimal adjusted";216;412;119;293;530;470
"1297";"1. Random";"1. Random";217;412;100;312;492;508
"1298";"6. Biased  coin";"6. Biased  coin";217;395;88;307;498;502
"1299";"2. Neyman known";"2. Neyman known";217;422;73;349;430;570
"1300";"3. RSIHR Known";"3. RSIHR Known";217;467;73;394;356;644
"1301";"4. Rosenberger known";"4. Rosenberger known";217;547;28;519;164;836
"1302";"5. Optimal adjusted";"5. Optimal adjusted";217;380;89;291;528;472
"1303";"1. Random";"1. Random";218;398;118;280;526;474
"1304";"6. Biased  coin";"6. Biased  coin";218;423;114;309;504;500
"1305";"2. Neyman known";"2. Neyman known";218;400;92;308;459;541
"1306";"3. RSIHR Known";"3. RSIHR Known";218;452;79;373;378;622
"1307";"4. Rosenberger known";"4. Rosenberger known";218;525;33;492;158;842
"1308";"5. Optimal adjusted";"5. Optimal adjusted";218;384;114;270;540;460
"1309";"1. Random";"1. Random";219;418;105;313;504;496
"1310";"6. Biased  coin";"6. Biased  coin";219;420;104;316;500;501
"1311";"2. Neyman known";"2. Neyman known";219;433;96;337;445;555
"1312";"3. RSIHR Known";"3. RSIHR Known";219;445;63;382;365;635
"1313";"4. Rosenberger known";"4. Rosenberger known";219;539;27;512;146;854
"1314";"5. Optimal adjusted";"5. Optimal adjusted";219;381;110;271;548;452
"1315";"1. Random";"1. Random";220;380;76;304;498;502
"1316";"6. Biased  coin";"6. Biased  coin";220;401;89;312;501;500
"1317";"2. Neyman known";"2. Neyman known";220;394;73;321;474;526
"1318";"3. RSIHR Known";"3. RSIHR Known";220;449;66;383;372;628
"1319";"4. Rosenberger known";"4. Rosenberger known";220;560;25;535;140;860
"1320";"5. Optimal adjusted";"5. Optimal adjusted";220;367;89;278;538;462
"1321";"1. Random";"1. Random";221;394;86;308;482;518
"1322";"6. Biased  coin";"6. Biased  coin";221;391;92;299;502;499
"1323";"2. Neyman known";"2. Neyman known";221;417;84;333;435;565
"1324";"3. RSIHR Known";"3. RSIHR Known";221;458;68;390;354;646
"1325";"4. Rosenberger known";"4. Rosenberger known";221;523;24;499;153;847
"1326";"5. Optimal adjusted";"5. Optimal adjusted";221;373;108;265;546;454
"1327";"1. Random";"1. Random";222;411;100;311;519;481
"1328";"6. Biased  coin";"6. Biased  coin";222;429;102;327;498;502
"1329";"2. Neyman known";"2. Neyman known";222;443;88;355;445;555
"1330";"3. RSIHR Known";"3. RSIHR Known";222;470;80;390;372;628
"1331";"4. Rosenberger known";"4. Rosenberger known";222;570;29;541;142;858
"1332";"5. Optimal adjusted";"5. Optimal adjusted";222;389;117;272;536;464
"1333";"1. Random";"1. Random";223;376;99;277;533;467
"1334";"6. Biased  coin";"6. Biased  coin";223;399;103;296;500;500
"1335";"2. Neyman known";"2. Neyman known";223;418;88;330;430;570
"1336";"3. RSIHR Known";"3. RSIHR Known";223;457;74;383;352;648
"1337";"4. Rosenberger known";"4. Rosenberger known";223;533;25;508;147;853
"1338";"5. Optimal adjusted";"5. Optimal adjusted";223;378;106;272;536;464
"1339";"1. Random";"1. Random";224;395;88;307;509;491
"1340";"6. Biased  coin";"6. Biased  coin";224;376;72;304;499;501
"1341";"2. Neyman known";"2. Neyman known";224;422;81;341;435;565
"1342";"3. RSIHR Known";"3. RSIHR Known";224;447;57;390;355;645
"1343";"4. Rosenberger known";"4. Rosenberger known";224;548;25;523;137;863
"1344";"5. Optimal adjusted";"5. Optimal adjusted";224;348;97;251;566;434
"1345";"1. Random";"1. Random";225;410;103;307;505;495
"1346";"6. Biased  coin";"6. Biased  coin";225;379;95;284;500;500
"1347";"2. Neyman known";"2. Neyman known";225;428;97;331;444;556
"1348";"3. RSIHR Known";"3. RSIHR Known";225;451;93;358;392;608
"1349";"4. Rosenberger known";"4. Rosenberger known";225;545;33;512;142;858
"1350";"5. Optimal adjusted";"5. Optimal adjusted";225;376;113;263;551;449
"1351";"1. Random";"1. Random";226;398;93;305;492;508
"1352";"6. Biased  coin";"6. Biased  coin";226;379;87;292;500;500
"1353";"2. Neyman known";"2. Neyman known";226;420;74;346;443;557
"1354";"3. RSIHR Known";"3. RSIHR Known";226;477;69;408;351;649
"1355";"4. Rosenberger known";"4. Rosenberger known";226;542;31;511;156;844
"1356";"5. Optimal adjusted";"5. Optimal adjusted";226;372;107;265;550;450
"1357";"1. Random";"1. Random";227;406;90;316;479;521
"1358";"6. Biased  coin";"6. Biased  coin";227;379;88;291;500;500
"1359";"2. Neyman known";"2. Neyman known";227;401;82;319;458;542
"1360";"3. RSIHR Known";"3. RSIHR Known";227;447;71;376;380;620
"1361";"4. Rosenberger known";"4. Rosenberger known";227;539;19;520;134;866
"1362";"5. Optimal adjusted";"5. Optimal adjusted";227;389;108;281;542;458
"1363";"1. Random";"1. Random";228;407;107;300;499;501
"1364";"6. Biased  coin";"6. Biased  coin";228;406;105;301;502;500
"1365";"2. Neyman known";"2. Neyman known";228;433;91;342;434;566
"1366";"3. RSIHR Known";"3. RSIHR Known";228;454;79;375;380;620
"1367";"4. Rosenberger known";"4. Rosenberger known";228;552;27;525;149;851
"1368";"5. Optimal adjusted";"5. Optimal adjusted";228;376;103;273;541;459
"1369";"1. Random";"1. Random";229;393;98;295;516;484
"1370";"6. Biased  coin";"6. Biased  coin";229;420;105;315;500;500
"1371";"2. Neyman known";"2. Neyman known";229;430;86;344;442;558
"1372";"3. RSIHR Known";"3. RSIHR Known";229;470;76;394;358;642
"1373";"4. Rosenberger known";"4. Rosenberger known";229;559;25;534;122;878
"1374";"5. Optimal adjusted";"5. Optimal adjusted";229;408;126;282;536;464
"1375";"1. Random";"1. Random";230;400;86;314;488;512
"1376";"6. Biased  coin";"6. Biased  coin";230;366;81;285;503;499
"1377";"2. Neyman known";"2. Neyman known";230;379;78;301;461;539
"1378";"3. RSIHR Known";"3. RSIHR Known";230;427;56;371;366;634
"1379";"4. Rosenberger known";"4. Rosenberger known";230;534;18;516;134;866
"1380";"5. Optimal adjusted";"5. Optimal adjusted";230;338;98;240;573;427
"1381";"1. Random";"1. Random";231;407;104;303;509;491
"1382";"6. Biased  coin";"6. Biased  coin";231;381;88;293;498;502
"1383";"2. Neyman known";"2. Neyman known";231;416;83;333;442;558
"1384";"3. RSIHR Known";"3. RSIHR Known";231;448;65;383;347;653
"1385";"4. Rosenberger known";"4. Rosenberger known";231;538;18;520;134;866
"1386";"5. Optimal adjusted";"5. Optimal adjusted";231;351;100;251;558;442
"1387";"1. Random";"1. Random";232;445;96;349;467;533
"1388";"6. Biased  coin";"6. Biased  coin";232;405;105;300;502;500
"1389";"2. Neyman known";"2. Neyman known";232;437;90;347;467;533
"1390";"3. RSIHR Known";"3. RSIHR Known";232;483;71;412;360;640
"1391";"4. Rosenberger known";"4. Rosenberger known";232;577;21;556;120;880
"1392";"5. Optimal adjusted";"5. Optimal adjusted";232;392;110;282;554;446
"1393";"1. Random";"1. Random";233;443;115;328;488;512
"1394";"6. Biased  coin";"6. Biased  coin";233;432;121;311;501;499
"1395";"2. Neyman known";"2. Neyman known";233;442;103;339;461;539
"1396";"3. RSIHR Known";"3. RSIHR Known";233;478;75;403;355;645
"1397";"4. Rosenberger known";"4. Rosenberger known";233;551;26;525;147;853
"1398";"5. Optimal adjusted";"5. Optimal adjusted";233;401;119;282;533;467
"1399";"1. Random";"1. Random";234;404;105;299;506;494
"1400";"6. Biased  coin";"6. Biased  coin";234;394;89;305;500;500
"1401";"2. Neyman known";"2. Neyman known";234;414;89;325;437;563
"1402";"3. RSIHR Known";"3. RSIHR Known";234;448;66;382;372;628
"1403";"4. Rosenberger known";"4. Rosenberger known";234;540;24;516;139;861
"1404";"5. Optimal adjusted";"5. Optimal adjusted";234;383;94;289;516;484
"1405";"1. Random";"1. Random";235;428;98;330;480;520
"1406";"6. Biased  coin";"6. Biased  coin";235;423;103;320;500;501
"1407";"2. Neyman known";"2. Neyman known";235;407;93;314;467;533
"1408";"3. RSIHR Known";"3. RSIHR Known";235;453;65;388;376;624
"1409";"4. Rosenberger known";"4. Rosenberger known";235;563;32;531;140;860
"1410";"5. Optimal adjusted";"5. Optimal adjusted";235;401;89;312;507;493
"1411";"1. Random";"1. Random";236;386;89;297;502;498
"1412";"6. Biased  coin";"6. Biased  coin";236;397;103;294;499;501
"1413";"2. Neyman known";"2. Neyman known";236;425;97;328;442;558
"1414";"3. RSIHR Known";"3. RSIHR Known";236;438;76;362;387;613
"1415";"4. Rosenberger known";"4. Rosenberger known";236;557;31;526;130;870
"1416";"5. Optimal adjusted";"5. Optimal adjusted";236;361;111;250;564;436
"1417";"1. Random";"1. Random";237;417;100;317;508;492
"1418";"6. Biased  coin";"6. Biased  coin";237;407;101;306;502;499
"1419";"2. Neyman known";"2. Neyman known";237;449;97;352;446;554
"1420";"3. RSIHR Known";"3. RSIHR Known";237;463;81;382;364;636
"1421";"4. Rosenberger known";"4. Rosenberger known";237;563;31;532;160;840
"1422";"5. Optimal adjusted";"5. Optimal adjusted";237;413;106;307;515;485
"1423";"1. Random";"1. Random";238;396;97;299;508;492
"1424";"6. Biased  coin";"6. Biased  coin";238;407;102;305;501;499
"1425";"2. Neyman known";"2. Neyman known";238;442;86;356;437;563
"1426";"3. RSIHR Known";"3. RSIHR Known";238;450;81;369;383;617
"1427";"4. Rosenberger known";"4. Rosenberger known";238;561;34;527;132;868
"1428";"5. Optimal adjusted";"5. Optimal adjusted";238;398;105;293;539;461
"1429";"1. Random";"1. Random";239;398;106;292;505;495
"1430";"6. Biased  coin";"6. Biased  coin";239;401;112;289;502;499
"1431";"2. Neyman known";"2. Neyman known";239;405;103;302;482;518
"1432";"3. RSIHR Known";"3. RSIHR Known";239;450;67;383;361;639
"1433";"4. Rosenberger known";"4. Rosenberger known";239;553;36;517;138;862
"1434";"5. Optimal adjusted";"5. Optimal adjusted";239;400;117;283;535;465
"1435";"1. Random";"1. Random";240;403;104;299;531;469
"1436";"6. Biased  coin";"6. Biased  coin";240;399;99;300;502;500
"1437";"2. Neyman known";"2. Neyman known";240;427;83;344;453;547
"1438";"3. RSIHR Known";"3. RSIHR Known";240;455;71;384;377;623
"1439";"4. Rosenberger known";"4. Rosenberger known";240;555;27;528;127;873
"1440";"5. Optimal adjusted";"5. Optimal adjusted";240;411;103;308;514;486
"1441";"1. Random";"1. Random";241;372;95;277;533;467
"1442";"6. Biased  coin";"6. Biased  coin";241;396;100;296;502;500
"1443";"2. Neyman known";"2. Neyman known";241;429;81;348;434;566
"1444";"3. RSIHR Known";"3. RSIHR Known";241;466;77;389;363;637
"1445";"4. Rosenberger known";"4. Rosenberger known";241;547;27;520;140;860
"1446";"5. Optimal adjusted";"5. Optimal adjusted";241;388;117;271;534;466
"1447";"1. Random";"1. Random";242;415;101;314;499;501
"1448";"6. Biased  coin";"6. Biased  coin";242;398;92;306;500;502
"1449";"2. Neyman known";"2. Neyman known";242;428;96;332;460;540
"1450";"3. RSIHR Known";"3. RSIHR Known";242;445;71;374;382;618
"1451";"4. Rosenberger known";"4. Rosenberger known";242;542;24;518;144;856
"1452";"5. Optimal adjusted";"5. Optimal adjusted";242;360;107;253;573;427
"1453";"1. Random";"1. Random";243;391;100;291;486;514
"1454";"6. Biased  coin";"6. Biased  coin";243;404;105;299;502;500
"1455";"2. Neyman known";"2. Neyman known";243;418;79;339;422;578
"1456";"3. RSIHR Known";"3. RSIHR Known";243;438;73;365;361;639
"1457";"4. Rosenberger known";"4. Rosenberger known";243;532;24;508;145;855
"1458";"5. Optimal adjusted";"5. Optimal adjusted";243;379;113;266;545;455
"1459";"1. Random";"1. Random";244;392;96;296;497;503
"1460";"6. Biased  coin";"6. Biased  coin";244;391;104;287;501;500
"1461";"2. Neyman known";"2. Neyman known";244;426;100;326;469;531
"1462";"3. RSIHR Known";"3. RSIHR Known";244;444;73;371;375;625
"1463";"4. Rosenberger known";"4. Rosenberger known";244;544;32;512;135;865
"1464";"5. Optimal adjusted";"5. Optimal adjusted";244;397;107;290;537;463
"1465";"1. Random";"1. Random";245;409;106;303;501;499
"1466";"6. Biased  coin";"6. Biased  coin";245;413;109;304;502;499
"1467";"2. Neyman known";"2. Neyman known";245;443;91;352;432;568
"1468";"3. RSIHR Known";"3. RSIHR Known";245;482;74;408;342;658
"1469";"4. Rosenberger known";"4. Rosenberger known";245;554;39;515;158;842
"1470";"5. Optimal adjusted";"5. Optimal adjusted";245;418;118;300;491;509
"1471";"1. Random";"1. Random";246;391;94;297;516;484
"1472";"6. Biased  coin";"6. Biased  coin";246;411;97;314;502;499
"1473";"2. Neyman known";"2. Neyman known";246;449;98;351;429;571
"1474";"3. RSIHR Known";"3. RSIHR Known";246;489;66;423;340;660
"1475";"4. Rosenberger known";"4. Rosenberger known";246;558;29;529;148;852
"1476";"5. Optimal adjusted";"5. Optimal adjusted";246;384;115;269;553;447
"1477";"1. Random";"1. Random";247;387;90;297;512;488
"1478";"6. Biased  coin";"6. Biased  coin";247;403;87;316;500;500
"1479";"2. Neyman known";"2. Neyman known";247;422;73;349;441;559
"1480";"3. RSIHR Known";"3. RSIHR Known";247;465;75;390;383;617
"1481";"4. Rosenberger known";"4. Rosenberger known";247;555;29;526;141;859
"1482";"5. Optimal adjusted";"5. Optimal adjusted";247;382;109;273;547;453
"1483";"1. Random";"1. Random";248;397;110;287;531;469
"1484";"6. Biased  coin";"6. Biased  coin";248;407;100;307;500;500
"1485";"2. Neyman known";"2. Neyman known";248;440;84;356;420;580
"1486";"3. RSIHR Known";"3. RSIHR Known";248;463;78;385;372;628
"1487";"4. Rosenberger known";"4. Rosenberger known";248;550;23;527;133;867
"1488";"5. Optimal adjusted";"5. Optimal adjusted";248;385;103;282;528;472
"1489";"1. Random";"1. Random";249;403;88;315;471;529
"1490";"6. Biased  coin";"6. Biased  coin";249;371;80;291;502;499
"1491";"2. Neyman known";"2. Neyman known";249;411;78;333;445;555
"1492";"3. RSIHR Known";"3. RSIHR Known";249;450;61;389;345;655
"1493";"4. Rosenberger known";"4. Rosenberger known";249;546;22;524;134;866
"1494";"5. Optimal adjusted";"5. Optimal adjusted";249;382;91;291;530;470
"1495";"1. Random";"1. Random";250;395;102;293;508;492
"1496";"6. Biased  coin";"6. Biased  coin";250;396;99;297;501;499
"1497";"2. Neyman known";"2. Neyman known";250;411;88;323;456;544
"1498";"3. RSIHR Known";"3. RSIHR Known";250;456;71;385;356;644
"1499";"4. Rosenberger known";"4. Rosenberger known";250;544;31;513;143;857
"1500";"5. Optimal adjusted";"5. Optimal adjusted";250;385;100;285;532;468
"1501";"1. Random";"1. Random";251;401;99;302;503;497
"1502";"6. Biased  coin";"6. Biased  coin";251;377;94;283;500;500
"1503";"2. Neyman known";"2. Neyman known";251;404;88;316;460;540
"1504";"3. RSIHR Known";"3. RSIHR Known";251;455;73;382;369;631
"1505";"4. Rosenberger known";"4. Rosenberger known";251;521;23;498;144;856
"1506";"5. Optimal adjusted";"5. Optimal adjusted";251;376;108;268;533;467
"1507";"1. Random";"1. Random";252;379;85;294;499;501
"1508";"6. Biased  coin";"6. Biased  coin";252;392;83;309;501;500
"1509";"2. Neyman known";"2. Neyman known";252;427;79;348;442;558
"1510";"3. RSIHR Known";"3. RSIHR Known";252;472;75;397;375;625
"1511";"4. Rosenberger known";"4. Rosenberger known";252;568;28;540;137;863
"1512";"5. Optimal adjusted";"5. Optimal adjusted";252;369;96;273;539;461
"1513";"1. Random";"1. Random";253;398;105;293;504;496
"1514";"6. Biased  coin";"6. Biased  coin";253;397;102;295;501;500
"1515";"2. Neyman known";"2. Neyman known";253;407;81;326;445;555
"1516";"3. RSIHR Known";"3. RSIHR Known";253;457;80;377;386;614
"1517";"4. Rosenberger known";"4. Rosenberger known";253;535;28;507;142;858
"1518";"5. Optimal adjusted";"5. Optimal adjusted";253;373;105;268;560;440
"1519";"1. Random";"1. Random";254;406;91;315;509;491
"1520";"6. Biased  coin";"6. Biased  coin";254;394;93;301;503;500
"1521";"2. Neyman known";"2. Neyman known";254;424;82;342;458;542
"1522";"3. RSIHR Known";"3. RSIHR Known";254;439;60;379;371;629
"1523";"4. Rosenberger known";"4. Rosenberger known";254;548;17;531;137;863
"1524";"5. Optimal adjusted";"5. Optimal adjusted";254;374;97;277;538;462
"1525";"1. Random";"1. Random";255;393;90;303;502;498
"1526";"6. Biased  coin";"6. Biased  coin";255;375;85;290;502;499
"1527";"2. Neyman known";"2. Neyman known";255;397;82;315;451;549
"1528";"3. RSIHR Known";"3. RSIHR Known";255;456;77;379;372;628
"1529";"4. Rosenberger known";"4. Rosenberger known";255;535;33;502;170;830
"1530";"5. Optimal adjusted";"5. Optimal adjusted";255;368;90;278;532;468
"1531";"1. Random";"1. Random";256;400;106;294;499;501
"1532";"6. Biased  coin";"6. Biased  coin";256;401;110;291;504;499
"1533";"2. Neyman known";"2. Neyman known";256;413;90;323;454;546
"1534";"3. RSIHR Known";"3. RSIHR Known";256;443;67;376;373;627
"1535";"4. Rosenberger known";"4. Rosenberger known";256;537;40;497;164;836
"1536";"5. Optimal adjusted";"5. Optimal adjusted";256;371;97;274;516;484
"1537";"1. Random";"1. Random";257;412;97;315;486;514
"1538";"6. Biased  coin";"6. Biased  coin";257;403;95;308;502;500
"1539";"2. Neyman known";"2. Neyman known";257;429;94;335;451;549
"1540";"3. RSIHR Known";"3. RSIHR Known";257;465;73;392;347;653
"1541";"4. Rosenberger known";"4. Rosenberger known";257;540;30;510;150;850
"1542";"5. Optimal adjusted";"5. Optimal adjusted";257;392;96;296;504;496
"1543";"1. Random";"1. Random";258;427;115;312;491;509
"1544";"6. Biased  coin";"6. Biased  coin";258;397;102;295;500;500
"1545";"2. Neyman known";"2. Neyman known";258;422;84;338;444;556
"1546";"3. RSIHR Known";"3. RSIHR Known";258;465;70;395;339;661
"1547";"4. Rosenberger known";"4. Rosenberger known";258;543;28;515;151;849
"1548";"5. Optimal adjusted";"5. Optimal adjusted";258;391;109;282;546;454
"1549";"1. Random";"1. Random";259;403;97;306;503;497
"1550";"6. Biased  coin";"6. Biased  coin";259;401;102;299;500;500
"1551";"2. Neyman known";"2. Neyman known";259;426;90;336;434;566
"1552";"3. RSIHR Known";"3. RSIHR Known";259;455;73;382;358;642
"1553";"4. Rosenberger known";"4. Rosenberger known";259;548;33;515;163;837
"1554";"5. Optimal adjusted";"5. Optimal adjusted";259;402;104;298;524;476
"1555";"1. Random";"1. Random";260;417;115;302;516;484
"1556";"6. Biased  coin";"6. Biased  coin";260;377;81;296;501;500
"1557";"2. Neyman known";"2. Neyman known";260;438;92;346;454;546
"1558";"3. RSIHR Known";"3. RSIHR Known";260;481;82;399;352;648
"1559";"4. Rosenberger known";"4. Rosenberger known";260;567;33;534;132;868
"1560";"5. Optimal adjusted";"5. Optimal adjusted";260;395;102;293;512;488
"1561";"1. Random";"1. Random";261;417;105;312;486;514
"1562";"6. Biased  coin";"6. Biased  coin";261;401;111;290;500;500
"1563";"2. Neyman known";"2. Neyman known";261;420;99;321;465;535
"1564";"3. RSIHR Known";"3. RSIHR Known";261;447;80;367;370;630
"1565";"4. Rosenberger known";"4. Rosenberger known";261;538;42;496;154;846
"1566";"5. Optimal adjusted";"5. Optimal adjusted";261;361;107;254;533;467
"1567";"1. Random";"1. Random";262;387;102;285;532;468
"1568";"6. Biased  coin";"6. Biased  coin";262;390;97;293;501;499
"1569";"2. Neyman known";"2. Neyman known";262;437;94;343;451;549
"1570";"3. RSIHR Known";"3. RSIHR Known";262;461;75;386;368;632
"1571";"4. Rosenberger known";"4. Rosenberger known";262;549;29;520;144;856
"1572";"5. Optimal adjusted";"5. Optimal adjusted";262;370;95;275;532;468
"1573";"1. Random";"1. Random";263;404;104;300;518;482
"1574";"6. Biased  coin";"6. Biased  coin";263;382;96;286;498;502
"1575";"2. Neyman known";"2. Neyman known";263;424;89;335;444;556
"1576";"3. RSIHR Known";"3. RSIHR Known";263;458;60;398;329;671
"1577";"4. Rosenberger known";"4. Rosenberger known";263;556;30;526;136;864
"1578";"5. Optimal adjusted";"5. Optimal adjusted";263;410;103;307;521;479
"1579";"1. Random";"1. Random";264;416;100;316;504;496
"1580";"6. Biased  coin";"6. Biased  coin";264;410;99;311;501;499
"1581";"2. Neyman known";"2. Neyman known";264;428;90;338;464;536
"1582";"3. RSIHR Known";"3. RSIHR Known";264;452;68;384;372;628
"1583";"4. Rosenberger known";"4. Rosenberger known";264;560;19;541;120;880
"1584";"5. Optimal adjusted";"5. Optimal adjusted";264;396;109;287;538;462
"1585";"1. Random";"1. Random";265;399;74;325;470;530
"1586";"6. Biased  coin";"6. Biased  coin";265;397;73;324;499;502
"1587";"2. Neyman known";"2. Neyman known";265;434;85;349;449;551
"1588";"3. RSIHR Known";"3. RSIHR Known";265;440;60;380;388;612
"1589";"4. Rosenberger known";"4. Rosenberger known";265;552;21;531;135;865
"1590";"5. Optimal adjusted";"5. Optimal adjusted";265;373;91;282;528;472
"1591";"1. Random";"1. Random";266;401;94;307;495;505
"1592";"6. Biased  coin";"6. Biased  coin";266;406;85;321;502;499
"1593";"2. Neyman known";"2. Neyman known";266;422;84;338;426;574
"1594";"3. RSIHR Known";"3. RSIHR Known";266;452;82;370;388;612
"1595";"4. Rosenberger known";"4. Rosenberger known";266;553;30;523;163;837
"1596";"5. Optimal adjusted";"5. Optimal adjusted";266;400;116;284;542;458
"1597";"1. Random";"1. Random";267;388;104;284;519;481
"1598";"6. Biased  coin";"6. Biased  coin";267;401;99;302;501;499
"1599";"2. Neyman known";"2. Neyman known";267;413;77;336;442;558
"1600";"3. RSIHR Known";"3. RSIHR Known";267;450;73;377;380;620
"1601";"4. Rosenberger known";"4. Rosenberger known";267;549;34;515;151;849
"1602";"5. Optimal adjusted";"5. Optimal adjusted";267;384;110;274;543;457
"1603";"1. Random";"1. Random";268;398;105;293;506;494
"1604";"6. Biased  coin";"6. Biased  coin";268;398;107;291;501;500
"1605";"2. Neyman known";"2. Neyman known";268;437;101;336;447;553
"1606";"3. RSIHR Known";"3. RSIHR Known";268;446;77;369;370;630
"1607";"4. Rosenberger known";"4. Rosenberger known";268;542;40;502;161;839
"1608";"5. Optimal adjusted";"5. Optimal adjusted";268;370;120;250;574;426
"1609";"1. Random";"1. Random";269;401;93;308;485;515
"1610";"6. Biased  coin";"6. Biased  coin";269;397;95;302;500;500
"1611";"2. Neyman known";"2. Neyman known";269;420;86;334;456;544
"1612";"3. RSIHR Known";"3. RSIHR Known";269;446;58;388;359;641
"1613";"4. Rosenberger known";"4. Rosenberger known";269;557;28;529;133;867
"1614";"5. Optimal adjusted";"5. Optimal adjusted";269;392;99;293;520;480
"1615";"1. Random";"1. Random";270;429;97;332;488;512
"1616";"6. Biased  coin";"6. Biased  coin";270;400;96;304;500;501
"1617";"2. Neyman known";"2. Neyman known";270;424;94;330;449;551
"1618";"3. RSIHR Known";"3. RSIHR Known";270;462;74;388;359;641
"1619";"4. Rosenberger known";"4. Rosenberger known";270;555;23;532;151;849
"1620";"5. Optimal adjusted";"5. Optimal adjusted";270;374;114;260;544;456
"1621";"1. Random";"1. Random";271;421;90;331;455;545
"1622";"6. Biased  coin";"6. Biased  coin";271;420;97;323;503;499
"1623";"2. Neyman known";"2. Neyman known";271;425;77;348;419;581
"1624";"3. RSIHR Known";"3. RSIHR Known";271;460;72;388;386;614
"1625";"4. Rosenberger known";"4. Rosenberger known";271;543;27;516;152;848
"1626";"5. Optimal adjusted";"5. Optimal adjusted";271;409;104;305;520;480
"1627";"1. Random";"1. Random";272;396;84;312;500;500
"1628";"6. Biased  coin";"6. Biased  coin";272;416;97;319;502;500
"1629";"2. Neyman known";"2. Neyman known";272;418;76;342;441;559
"1630";"3. RSIHR Known";"3. RSIHR Known";272;474;69;405;361;639
"1631";"4. Rosenberger known";"4. Rosenberger known";272;568;30;538;133;867
"1632";"5. Optimal adjusted";"5. Optimal adjusted";272;415;110;305;533;467
"1633";"1. Random";"1. Random";273;403;109;294;514;486
"1634";"6. Biased  coin";"6. Biased  coin";273;399;96;303;502;500
"1635";"2. Neyman known";"2. Neyman known";273;427;91;336;443;557
"1636";"3. RSIHR Known";"3. RSIHR Known";273;486;87;399;364;636
"1637";"4. Rosenberger known";"4. Rosenberger known";273;547;29;518;137;863
"1638";"5. Optimal adjusted";"5. Optimal adjusted";273;395;112;283;528;472
"1639";"1. Random";"1. Random";274;407;103;304;490;510
"1640";"6. Biased  coin";"6. Biased  coin";274;422;113;309;500;501
"1641";"2. Neyman known";"2. Neyman known";274;413;91;322;454;546
"1642";"3. RSIHR Known";"3. RSIHR Known";274;458;65;393;347;653
"1643";"4. Rosenberger known";"4. Rosenberger known";274;542;33;509;145;855
"1644";"5. Optimal adjusted";"5. Optimal adjusted";274;390;118;272;539;461
"1645";"1. Random";"1. Random";275;388;107;281;525;475
"1646";"6. Biased  coin";"6. Biased  coin";275;412;114;298;502;498
"1647";"2. Neyman known";"2. Neyman known";275;439;100;339;448;552
"1648";"3. RSIHR Known";"3. RSIHR Known";275;452;77;375;355;645
"1649";"4. Rosenberger known";"4. Rosenberger known";275;549;29;520;138;862
"1650";"5. Optimal adjusted";"5. Optimal adjusted";275;381;108;273;535;465
"1651";"1. Random";"1. Random";276;399;92;307;477;523
"1652";"6. Biased  coin";"6. Biased  coin";276;390;78;312;499;501
"1653";"2. Neyman known";"2. Neyman known";276;422;86;336;450;550
"1654";"3. RSIHR Known";"3. RSIHR Known";276;453;76;377;369;631
"1655";"4. Rosenberger known";"4. Rosenberger known";276;558;29;529;134;866
"1656";"5. Optimal adjusted";"5. Optimal adjusted";276;372;97;275;545;455
"1657";"1. Random";"1. Random";277;407;107;300;507;493
"1658";"6. Biased  coin";"6. Biased  coin";277;392;99;293;499;501
"1659";"2. Neyman known";"2. Neyman known";277;428;91;337;420;580
"1660";"3. RSIHR Known";"3. RSIHR Known";277;449;74;375;365;635
"1661";"4. Rosenberger known";"4. Rosenberger known";277;552;33;519;144;856
"1662";"5. Optimal adjusted";"5. Optimal adjusted";277;395;117;278;536;464
"1663";"1. Random";"1. Random";278;418;114;304;504;496
"1664";"6. Biased  coin";"6. Biased  coin";278;406;104;302;503;499
"1665";"2. Neyman known";"2. Neyman known";278;400;94;306;456;544
"1666";"3. RSIHR Known";"3. RSIHR Known";278;463;74;389;368;632
"1667";"4. Rosenberger known";"4. Rosenberger known";278;560;32;528;142;858
"1668";"5. Optimal adjusted";"5. Optimal adjusted";278;418;121;297;522;478
"1669";"1. Random";"1. Random";279;393;107;286;514;486
"1670";"6. Biased  coin";"6. Biased  coin";279;415;107;308;501;500
"1671";"2. Neyman known";"2. Neyman known";279;416;85;331;445;555
"1672";"3. RSIHR Known";"3. RSIHR Known";279;465;75;390;350;650
"1673";"4. Rosenberger known";"4. Rosenberger known";279;556;28;528;111;889
"1674";"5. Optimal adjusted";"5. Optimal adjusted";279;383;104;279;529;471
"1675";"1. Random";"1. Random";280;388;87;301;504;496
"1676";"6. Biased  coin";"6. Biased  coin";280;409;91;318;501;499
"1677";"2. Neyman known";"2. Neyman known";280;429;82;347;427;573
"1678";"3. RSIHR Known";"3. RSIHR Known";280;456;66;390;366;634
"1679";"4. Rosenberger known";"4. Rosenberger known";280;556;15;541;126;874
"1680";"5. Optimal adjusted";"5. Optimal adjusted";280;395;91;304;525;475
"1681";"1. Random";"1. Random";281;393;89;304;523;477
"1682";"6. Biased  coin";"6. Biased  coin";281;405;88;317;500;500
"1683";"2. Neyman known";"2. Neyman known";281;392;76;316;474;526
"1684";"3. RSIHR Known";"3. RSIHR Known";281;441;55;386;369;631
"1685";"4. Rosenberger known";"4. Rosenberger known";281;554;24;530;141;859
"1686";"5. Optimal adjusted";"5. Optimal adjusted";281;374;94;280;536;464
"1687";"1. Random";"1. Random";282;417;101;316;511;489
"1688";"6. Biased  coin";"6. Biased  coin";282;423;100;323;501;500
"1689";"2. Neyman known";"2. Neyman known";282;450;91;359;445;555
"1690";"3. RSIHR Known";"3. RSIHR Known";282;506;61;445;309;691
"1691";"4. Rosenberger known";"4. Rosenberger known";282;580;22;558;138;862
"1692";"5. Optimal adjusted";"5. Optimal adjusted";282;406;116;290;548;452
"1693";"1. Random";"1. Random";283;417;99;318;475;525
"1694";"6. Biased  coin";"6. Biased  coin";283;397;90;307;499;502
"1695";"2. Neyman known";"2. Neyman known";283;427;85;342;441;559
"1696";"3. RSIHR Known";"3. RSIHR Known";283;457;83;374;392;608
"1697";"4. Rosenberger known";"4. Rosenberger known";283;554;28;526;137;863
"1698";"5. Optimal adjusted";"5. Optimal adjusted";283;392;112;280;542;458
"1699";"1. Random";"1. Random";284;359;84;275;530;470
"1700";"6. Biased  coin";"6. Biased  coin";284;385;86;299;503;498
"1701";"2. Neyman known";"2. Neyman known";284;404;78;326;429;571
"1702";"3. RSIHR Known";"3. RSIHR Known";284;438;62;376;353;647
"1703";"4. Rosenberger known";"4. Rosenberger known";284;529;29;500;138;862
"1704";"5. Optimal adjusted";"5. Optimal adjusted";284;359;108;251;557;443
"1705";"1. Random";"1. Random";285;404;109;295;525;475
"1706";"6. Biased  coin";"6. Biased  coin";285;407;110;297;503;498
"1707";"2. Neyman known";"2. Neyman known";285;436;94;342;459;541
"1708";"3. RSIHR Known";"3. RSIHR Known";285;458;72;386;367;633
"1709";"4. Rosenberger known";"4. Rosenberger known";285;538;32;506;156;844
"1710";"5. Optimal adjusted";"5. Optimal adjusted";285;375;115;260;562;438
"1711";"1. Random";"1. Random";286;409;99;310;500;500
"1712";"6. Biased  coin";"6. Biased  coin";286;429;106;323;499;501
"1713";"2. Neyman known";"2. Neyman known";286;431;87;344;447;553
"1714";"3. RSIHR Known";"3. RSIHR Known";286;456;67;389;350;650
"1715";"4. Rosenberger known";"4. Rosenberger known";286;566;27;539;136;864
"1716";"5. Optimal adjusted";"5. Optimal adjusted";286;409;117;292;529;471
"1717";"1. Random";"1. Random";287;392;93;299;489;511
"1718";"6. Biased  coin";"6. Biased  coin";287;408;106;302;501;500
"1719";"2. Neyman known";"2. Neyman known";287;442;96;346;457;543
"1720";"3. RSIHR Known";"3. RSIHR Known";287;469;72;397;367;633
"1721";"4. Rosenberger known";"4. Rosenberger known";287;545;28;517;158;842
"1722";"5. Optimal adjusted";"5. Optimal adjusted";287;391;106;285;528;472
"1723";"1. Random";"1. Random";288;414;113;301;497;503
"1724";"6. Biased  coin";"6. Biased  coin";288;410;124;286;500;500
"1725";"2. Neyman known";"2. Neyman known";288;438;106;332;436;564
"1726";"3. RSIHR Known";"3. RSIHR Known";288;469;85;384;364;636
"1727";"4. Rosenberger known";"4. Rosenberger known";288;548;36;512;147;853
"1728";"5. Optimal adjusted";"5. Optimal adjusted";288;383;121;262;554;446
"1729";"1. Random";"1. Random";289;432;93;339;465;535
"1730";"6. Biased  coin";"6. Biased  coin";289;408;98;310;498;502
"1731";"2. Neyman known";"2. Neyman known";289;450;100;350;448;552
"1732";"3. RSIHR Known";"3. RSIHR Known";289;465;76;389;366;634
"1733";"4. Rosenberger known";"4. Rosenberger known";289;561;25;536;140;860
"1734";"5. Optimal adjusted";"5. Optimal adjusted";289;402;112;290;524;476
"1735";"1. Random";"1. Random";290;407;83;324;474;526
"1736";"6. Biased  coin";"6. Biased  coin";290;401;100;301;501;500
"1737";"2. Neyman known";"2. Neyman known";290;425;95;330;459;541
"1738";"3. RSIHR Known";"3. RSIHR Known";290;454;67;387;365;635
"1739";"4. Rosenberger known";"4. Rosenberger known";290;549;33;516;150;850
"1740";"5. Optimal adjusted";"5. Optimal adjusted";290;389;101;288;531;469
"1741";"1. Random";"1. Random";291;401;94;307;508;492
"1742";"6. Biased  coin";"6. Biased  coin";291;426;99;327;503;499
"1743";"2. Neyman known";"2. Neyman known";291;450;98;352;436;564
"1744";"3. RSIHR Known";"3. RSIHR Known";291;477;80;397;372;628
"1745";"4. Rosenberger known";"4. Rosenberger known";291;562;33;529;142;858
"1746";"5. Optimal adjusted";"5. Optimal adjusted";291;396;115;281;546;454
"1747";"1. Random";"1. Random";292;394;104;290;513;487
"1748";"6. Biased  coin";"6. Biased  coin";292;421;107;314;504;501
"1749";"2. Neyman known";"2. Neyman known";292;431;109;322;471;529
"1750";"3. RSIHR Known";"3. RSIHR Known";292;457;72;385;371;629
"1751";"4. Rosenberger known";"4. Rosenberger known";292;526;31;495;156;844
"1752";"5. Optimal adjusted";"5. Optimal adjusted";292;410;119;291;541;459
"1753";"1. Random";"1. Random";293;395;103;292;501;499
"1754";"6. Biased  coin";"6. Biased  coin";293;415;103;312;500;501
"1755";"2. Neyman known";"2. Neyman known";293;442;90;352;436;564
"1756";"3. RSIHR Known";"3. RSIHR Known";293;479;65;414;323;677
"1757";"4. Rosenberger known";"4. Rosenberger known";293;546;23;523;136;864
"1758";"5. Optimal adjusted";"5. Optimal adjusted";293;391;105;286;524;476
"1759";"1. Random";"1. Random";294;420;116;304;522;478
"1760";"6. Biased  coin";"6. Biased  coin";294;387;91;296;501;500
"1761";"2. Neyman known";"2. Neyman known";294;420;97;323;471;529
"1762";"3. RSIHR Known";"3. RSIHR Known";294;454;80;374;394;606
"1763";"4. Rosenberger known";"4. Rosenberger known";294;545;25;520;132;868
"1764";"5. Optimal adjusted";"5. Optimal adjusted";294;406;116;290;526;474
"1765";"1. Random";"1. Random";295;397;93;304;490;510
"1766";"6. Biased  coin";"6. Biased  coin";295;390;92;298;499;502
"1767";"2. Neyman known";"2. Neyman known";295;441;93;348;432;568
"1768";"3. RSIHR Known";"3. RSIHR Known";295;462;71;391;363;637
"1769";"4. Rosenberger known";"4. Rosenberger known";295;540;29;511;152;848
"1770";"5. Optimal adjusted";"5. Optimal adjusted";295;379;99;280;530;470
"1771";"1. Random";"1. Random";296;431;112;319;492;508
"1772";"6. Biased  coin";"6. Biased  coin";296;411;102;309;501;500
"1773";"2. Neyman known";"2. Neyman known";296;422;88;334;457;543
"1774";"3. RSIHR Known";"3. RSIHR Known";296;455;89;366;391;609
"1775";"4. Rosenberger known";"4. Rosenberger known";296;551;33;518;154;846
"1776";"5. Optimal adjusted";"5. Optimal adjusted";296;389;106;283;524;476
"1777";"1. Random";"1. Random";297;381;100;281;530;470
"1778";"6. Biased  coin";"6. Biased  coin";297;403;113;290;501;500
"1779";"2. Neyman known";"2. Neyman known";297;428;100;328;448;552
"1780";"3. RSIHR Known";"3. RSIHR Known";297;455;84;371;365;635
"1781";"4. Rosenberger known";"4. Rosenberger known";297;553;32;521;136;864
"1782";"5. Optimal adjusted";"5. Optimal adjusted";297;391;100;291;534;466
"1783";"1. Random";"1. Random";298;405;106;299;483;517
"1784";"6. Biased  coin";"6. Biased  coin";298;408;103;305;502;499
"1785";"2. Neyman known";"2. Neyman known";298;397;96;301;466;534
"1786";"3. RSIHR Known";"3. RSIHR Known";298;461;64;397;344;656
"1787";"4. Rosenberger known";"4. Rosenberger known";298;539;32;507;154;846
"1788";"5. Optimal adjusted";"5. Optimal adjusted";298;390;106;284;526;474
"1789";"1. Random";"1. Random";299;408;97;311;495;505
"1790";"6. Biased  coin";"6. Biased  coin";299;382;98;284;500;500
"1791";"2. Neyman known";"2. Neyman known";299;398;90;308;473;527
"1792";"3. RSIHR Known";"3. RSIHR Known";299;455;75;380;364;636
"1793";"4. Rosenberger known";"4. Rosenberger known";299;548;26;522;131;869
"1794";"5. Optimal adjusted";"5. Optimal adjusted";299;372;106;266;550;450
"1795";"1. Random";"1. Random";300;416;104;312;485;515
"1796";"6. Biased  coin";"6. Biased  coin";300;414;104;310;500;500
"1797";"2. Neyman known";"2. Neyman known";300;424;94;330;456;544
"1798";"3. RSIHR Known";"3. RSIHR Known";300;462;77;385;361;639
"1799";"4. Rosenberger known";"4. Rosenberger known";300;550;30;520;129;871
"1800";"5. Optimal adjusted";"5. Optimal adjusted";300;392;110;282;540;460
"1801";"1. Random";"1. Random";301;410;117;293;532;468
"1802";"6. Biased  coin";"6. Biased  coin";301;418;113;305;500;501
"1803";"2. Neyman known";"2. Neyman known";301;430;93;337;462;538
"1804";"3. RSIHR Known";"3. RSIHR Known";301;469;80;389;367;633
"1805";"4. Rosenberger known";"4. Rosenberger known";301;559;33;526;140;860
"1806";"5. Optimal adjusted";"5. Optimal adjusted";301;420;120;300;519;481
"1807";"1. Random";"1. Random";302;403;108;295;499;501
"1808";"6. Biased  coin";"6. Biased  coin";302;394;88;306;500;500
"1809";"2. Neyman known";"2. Neyman known";302;428;92;336;460;540
"1810";"3. RSIHR Known";"3. RSIHR Known";302;465;77;388;366;634
"1811";"4. Rosenberger known";"4. Rosenberger known";302;547;27;520;136;864
"1812";"5. Optimal adjusted";"5. Optimal adjusted";302;395;103;292;527;473
"1813";"1. Random";"1. Random";303;395;106;289;512;488
"1814";"6. Biased  coin";"6. Biased  coin";303;399;107;292;501;500
"1815";"2. Neyman known";"2. Neyman known";303;424;81;343;452;548
"1816";"3. RSIHR Known";"3. RSIHR Known";303;462;81;381;372;628
"1817";"4. Rosenberger known";"4. Rosenberger known";303;542;28;514;133;867
"1818";"5. Optimal adjusted";"5. Optimal adjusted";303;396;94;302;504;496
"1819";"1. Random";"1. Random";304;400;105;295;479;521
"1820";"6. Biased  coin";"6. Biased  coin";304;398;117;281;500;502
"1821";"2. Neyman known";"2. Neyman known";304;408;91;317;419;581
"1822";"3. RSIHR Known";"3. RSIHR Known";304;442;68;374;340;660
"1823";"4. Rosenberger known";"4. Rosenberger known";304;506;36;470;156;844
"1824";"5. Optimal adjusted";"5. Optimal adjusted";304;382;120;262;538;462
"1825";"1. Random";"1. Random";305;394;95;299;494;506
"1826";"6. Biased  coin";"6. Biased  coin";305;401;98;303;500;500
"1827";"2. Neyman known";"2. Neyman known";305;408;78;330;443;557
"1828";"3. RSIHR Known";"3. RSIHR Known";305;439;72;367;374;626
"1829";"4. Rosenberger known";"4. Rosenberger known";305;558;36;522;130;870
"1830";"5. Optimal adjusted";"5. Optimal adjusted";305;377;110;267;547;453
"1831";"1. Random";"1. Random";306;390;98;292;519;481
"1832";"6. Biased  coin";"6. Biased  coin";306;394;90;304;499;501
"1833";"2. Neyman known";"2. Neyman known";306;430;99;331;450;550
"1834";"3. RSIHR Known";"3. RSIHR Known";306;463;69;394;346;654
"1835";"4. Rosenberger known";"4. Rosenberger known";306;551;33;518;147;853
"1836";"5. Optimal adjusted";"5. Optimal adjusted";306;415;115;300;508;492
"1837";"1. Random";"1. Random";307;411;97;314;497;503
"1838";"6. Biased  coin";"6. Biased  coin";307;425;103;322;500;500
"1839";"2. Neyman known";"2. Neyman known";307;409;83;326;469;531
"1840";"3. RSIHR Known";"3. RSIHR Known";307;451;60;391;369;631
"1841";"4. Rosenberger known";"4. Rosenberger known";307;559;20;539;129;871
"1842";"5. Optimal adjusted";"5. Optimal adjusted";307;395;96;299;509;491
"1843";"1. Random";"1. Random";308;402;75;327;467;533
"1844";"6. Biased  coin";"6. Biased  coin";308;393;86;307;501;500
"1845";"2. Neyman known";"2. Neyman known";308;415;75;340;466;534
"1846";"3. RSIHR Known";"3. RSIHR Known";308;435;66;369;371;629
"1847";"4. Rosenberger known";"4. Rosenberger known";308;541;26;515;145;855
"1848";"5. Optimal adjusted";"5. Optimal adjusted";308;376;93;283;537;463
"1849";"1. Random";"1. Random";309;411;102;309;485;515
"1850";"6. Biased  coin";"6. Biased  coin";309;391;105;286;502;498
"1851";"2. Neyman known";"2. Neyman known";309;393;88;305;452;548
"1852";"3. RSIHR Known";"3. RSIHR Known";309;445;66;379;360;640
"1853";"4. Rosenberger known";"4. Rosenberger known";309;557;24;533;113;887
"1854";"5. Optimal adjusted";"5. Optimal adjusted";309;406;121;285;536;464
"1855";"1. Random";"1. Random";310;408;98;310;500;500
"1856";"6. Biased  coin";"6. Biased  coin";310;426;109;317;501;500
"1857";"2. Neyman known";"2. Neyman known";310;447;106;341;464;536
"1858";"3. RSIHR Known";"3. RSIHR Known";310;487;74;413;348;652
"1859";"4. Rosenberger known";"4. Rosenberger known";310;575;32;543;141;859
"1860";"5. Optimal adjusted";"5. Optimal adjusted";310;397;114;283;537;463
"1861";"1. Random";"1. Random";311;397;92;305;484;516
"1862";"6. Biased  coin";"6. Biased  coin";311;396;101;295;504;501
"1863";"2. Neyman known";"2. Neyman known";311;426;79;347;422;578
"1864";"3. RSIHR Known";"3. RSIHR Known";311;443;72;371;372;628
"1865";"4. Rosenberger known";"4. Rosenberger known";311;548;29;519;134;866
"1866";"5. Optimal adjusted";"5. Optimal adjusted";311;382;113;269;532;468
"1867";"1. Random";"1. Random";312;412;98;314;483;517
"1868";"6. Biased  coin";"6. Biased  coin";312;384;87;297;502;499
"1869";"2. Neyman known";"2. Neyman known";312;416;89;327;442;558
"1870";"3. RSIHR Known";"3. RSIHR Known";312;447;69;378;363;637
"1871";"4. Rosenberger known";"4. Rosenberger known";312;530;21;509;134;866
"1872";"5. Optimal adjusted";"5. Optimal adjusted";312;386;110;276;559;441
"1873";"1. Random";"1. Random";313;412;101;311;477;523
"1874";"6. Biased  coin";"6. Biased  coin";313;392;100;292;500;500
"1875";"2. Neyman known";"2. Neyman known";313;426;106;320;470;530
"1876";"3. RSIHR Known";"3. RSIHR Known";313;472;80;392;366;634
"1877";"4. Rosenberger known";"4. Rosenberger known";313;536;32;504;160;840
"1878";"5. Optimal adjusted";"5. Optimal adjusted";313;383;107;276;522;478
"1879";"1. Random";"1. Random";314;406;118;288;514;486
"1880";"6. Biased  coin";"6. Biased  coin";314;418;106;312;501;500
"1881";"2. Neyman known";"2. Neyman known";314;430;113;317;484;516
"1882";"3. RSIHR Known";"3. RSIHR Known";314;483;79;404;355;645
"1883";"4. Rosenberger known";"4. Rosenberger known";314;550;32;518;135;865
"1884";"5. Optimal adjusted";"5. Optimal adjusted";314;394;109;285;533;467
"1885";"1. Random";"1. Random";315;386;103;283;533;467
"1886";"6. Biased  coin";"6. Biased  coin";315;421;102;319;499;501
"1887";"2. Neyman known";"2. Neyman known";315;415;86;329;454;546
"1888";"3. RSIHR Known";"3. RSIHR Known";315;461;70;391;357;643
"1889";"4. Rosenberger known";"4. Rosenberger known";315;532;27;505;149;851
"1890";"5. Optimal adjusted";"5. Optimal adjusted";315;405;104;301;523;477
"1891";"1. Random";"1. Random";316;414;102;312;503;497
"1892";"6. Biased  coin";"6. Biased  coin";316;399;91;308;501;500
"1893";"2. Neyman known";"2. Neyman known";316;443;92;351;467;533
"1894";"3. RSIHR Known";"3. RSIHR Known";316;486;68;418;346;654
"1895";"4. Rosenberger known";"4. Rosenberger known";316;569;31;538;156;844
"1896";"5. Optimal adjusted";"5. Optimal adjusted";316;375;93;282;541;459
"1897";"1. Random";"1. Random";317;397;95;302;489;511
"1898";"6. Biased  coin";"6. Biased  coin";317;403;104;299;501;500
"1899";"2. Neyman known";"2. Neyman known";317;408;97;311;462;538
"1900";"3. RSIHR Known";"3. RSIHR Known";317;455;66;389;359;641
"1901";"4. Rosenberger known";"4. Rosenberger known";317;527;23;504;144;856
"1902";"5. Optimal adjusted";"5. Optimal adjusted";317;368;101;267;546;454
"1903";"1. Random";"1. Random";318;374;91;283;479;521
"1904";"6. Biased  coin";"6. Biased  coin";318;420;112;308;500;500
"1905";"2. Neyman known";"2. Neyman known";318;430;93;337;434;566
"1906";"3. RSIHR Known";"3. RSIHR Known";318;445;79;366;382;618
"1907";"4. Rosenberger known";"4. Rosenberger known";318;544;29;515;131;869
"1908";"5. Optimal adjusted";"5. Optimal adjusted";318;375;103;272;541;459
"1909";"1. Random";"1. Random";319;402;109;293;505;495
"1910";"6. Biased  coin";"6. Biased  coin";319;408;102;306;500;500
"1911";"2. Neyman known";"2. Neyman known";319;426;89;337;444;556
"1912";"3. RSIHR Known";"3. RSIHR Known";319;483;89;394;375;625
"1913";"4. Rosenberger known";"4. Rosenberger known";319;546;35;511;158;842
"1914";"5. Optimal adjusted";"5. Optimal adjusted";319;396;106;290;513;487
"1915";"1. Random";"1. Random";320;433;104;329;488;512
"1916";"6. Biased  coin";"6. Biased  coin";320;415;99;316;501;499
"1917";"2. Neyman known";"2. Neyman known";320;434;93;341;456;544
"1918";"3. RSIHR Known";"3. RSIHR Known";320;465;67;398;347;653
"1919";"4. Rosenberger known";"4. Rosenberger known";320;554;38;516;184;816
"1920";"5. Optimal adjusted";"5. Optimal adjusted";320;390;115;275;570;430
"1921";"1. Random";"1. Random";321;404;108;296;507;493
"1922";"6. Biased  coin";"6. Biased  coin";321;417;103;314;501;499
"1923";"2. Neyman known";"2. Neyman known";321;415;86;329;443;557
"1924";"3. RSIHR Known";"3. RSIHR Known";321;454;67;387;346;654
"1925";"4. Rosenberger known";"4. Rosenberger known";321;556;23;533;142;858
"1926";"5. Optimal adjusted";"5. Optimal adjusted";321;366;108;258;545;455
"1927";"1. Random";"1. Random";322;404;114;290;517;483
"1928";"6. Biased  coin";"6. Biased  coin";322;385;106;279;501;500
"1929";"2. Neyman known";"2. Neyman known";322;406;95;311;481;519
"1930";"3. RSIHR Known";"3. RSIHR Known";322;471;75;396;345;655
"1931";"4. Rosenberger known";"4. Rosenberger known";322;540;29;511;150;850
"1932";"5. Optimal adjusted";"5. Optimal adjusted";322;382;119;263;552;448
"1933";"1. Random";"1. Random";323;399;120;279;519;481
"1934";"6. Biased  coin";"6. Biased  coin";323;413;122;291;502;501
"1935";"2. Neyman known";"2. Neyman known";323;419;105;314;460;540
"1936";"3. RSIHR Known";"3. RSIHR Known";323;443;71;372;349;651
"1937";"4. Rosenberger known";"4. Rosenberger known";323;525;34;491;139;861
"1938";"5. Optimal adjusted";"5. Optimal adjusted";323;404;122;282;510;490
"1939";"1. Random";"1. Random";324;386;108;278;500;500
"1940";"6. Biased  coin";"6. Biased  coin";324;380;82;298;500;500
"1941";"2. Neyman known";"2. Neyman known";324;419;85;334;439;561
"1942";"3. RSIHR Known";"3. RSIHR Known";324;441;68;373;371;629
"1943";"4. Rosenberger known";"4. Rosenberger known";324;543;27;516;142;858
"1944";"5. Optimal adjusted";"5. Optimal adjusted";324;390;115;275;544;456
"1945";"1. Random";"1. Random";325;403;100;303;505;495
"1946";"6. Biased  coin";"6. Biased  coin";325;408;98;310;500;501
"1947";"2. Neyman known";"2. Neyman known";325;398;84;314;470;530
"1948";"3. RSIHR Known";"3. RSIHR Known";325;476;72;404;341;659
"1949";"4. Rosenberger known";"4. Rosenberger known";325;533;28;505;143;857
"1950";"5. Optimal adjusted";"5. Optimal adjusted";325;399;111;288;530;470
"1951";"1. Random";"1. Random";326;399;94;305;511;489
"1952";"6. Biased  coin";"6. Biased  coin";326;408;110;298;500;500
"1953";"2. Neyman known";"2. Neyman known";326;432;96;336;457;543
"1954";"3. RSIHR Known";"3. RSIHR Known";326;466;82;384;379;621
"1955";"4. Rosenberger known";"4. Rosenberger known";326;556;31;525;154;846
"1956";"5. Optimal adjusted";"5. Optimal adjusted";326;389;105;284;534;466
"1957";"1. Random";"1. Random";327;415;106;309;500;500
"1958";"6. Biased  coin";"6. Biased  coin";327;430;107;323;501;499
"1959";"2. Neyman known";"2. Neyman known";327;445;90;355;434;566
"1960";"3. RSIHR Known";"3. RSIHR Known";327;466;79;387;352;648
"1961";"4. Rosenberger known";"4. Rosenberger known";327;559;30;529;134;866
"1962";"5. Optimal adjusted";"5. Optimal adjusted";327;396;117;279;546;454
"1963";"1. Random";"1. Random";328;403;95;308;501;499
"1964";"6. Biased  coin";"6. Biased  coin";328;392;92;300;500;501
"1965";"2. Neyman known";"2. Neyman known";328;414;89;325;452;548
"1966";"3. RSIHR Known";"3. RSIHR Known";328;483;83;400;371;629
"1967";"4. Rosenberger known";"4. Rosenberger known";328;548;28;520;134;866
"1968";"5. Optimal adjusted";"5. Optimal adjusted";328;390;101;289;524;476
"1969";"1. Random";"1. Random";329;415;108;307;493;507
"1970";"6. Biased  coin";"6. Biased  coin";329;393;96;297;500;500
"1971";"2. Neyman known";"2. Neyman known";329;423;84;339;445;555
"1972";"3. RSIHR Known";"3. RSIHR Known";329;449;74;375;358;642
"1973";"4. Rosenberger known";"4. Rosenberger known";329;543;29;514;144;856
"1974";"5. Optimal adjusted";"5. Optimal adjusted";329;370;105;265;543;457
"1975";"1. Random";"1. Random";330;414;99;315;485;515
"1976";"6. Biased  coin";"6. Biased  coin";330;416;110;306;500;500
"1977";"2. Neyman known";"2. Neyman known";330;442;109;333;458;542
"1978";"3. RSIHR Known";"3. RSIHR Known";330;447;83;364;378;622
"1979";"4. Rosenberger known";"4. Rosenberger known";330;544;27;517;134;866
"1980";"5. Optimal adjusted";"5. Optimal adjusted";330;410;120;290;546;454
"1981";"1. Random";"1. Random";331;384;98;286;517;483
"1982";"6. Biased  coin";"6. Biased  coin";331;382;88;294;502;499
"1983";"2. Neyman known";"2. Neyman known";331;452;83;369;422;578
"1984";"3. RSIHR Known";"3. RSIHR Known";331;472;78;394;356;644
"1985";"4. Rosenberger known";"4. Rosenberger known";331;546;20;526;126;874
"1986";"5. Optimal adjusted";"5. Optimal adjusted";331;367;102;265;544;456
"1987";"1. Random";"1. Random";332;420;97;323;488;512
"1988";"6. Biased  coin";"6. Biased  coin";332;395;102;293;501;500
"1989";"2. Neyman known";"2. Neyman known";332;424;105;319;441;559
"1990";"3. RSIHR Known";"3. RSIHR Known";332;448;72;376;375;625
"1991";"4. Rosenberger known";"4. Rosenberger known";332;542;26;516;147;853
"1992";"5. Optimal adjusted";"5. Optimal adjusted";332;381;98;283;518;482
"1993";"1. Random";"1. Random";333;401;99;302;515;485
"1994";"6. Biased  coin";"6. Biased  coin";333;410;104;306;501;500
"1995";"2. Neyman known";"2. Neyman known";333;429;102;327;481;519
"1996";"3. RSIHR Known";"3. RSIHR Known";333;460;79;381;377;623
"1997";"4. Rosenberger known";"4. Rosenberger known";333;552;41;511;170;830
"1998";"5. Optimal adjusted";"5. Optimal adjusted";333;403;120;283;540;460
"1999";"1. Random";"1. Random";334;403;106;297;516;484
"2000";"6. Biased  coin";"6. Biased  coin";334;401;93;308;501;500
"2001";"2. Neyman known";"2. Neyman known";334;446;81;365;443;557
"2002";"3. RSIHR Known";"3. RSIHR Known";334;456;68;388;382;618
"2003";"4. Rosenberger known";"4. Rosenberger known";334;564;29;535;163;837
"2004";"5. Optimal adjusted";"5. Optimal adjusted";334;395;112;283;558;442
"2005";"1. Random";"1. Random";335;396;89;307;510;490
"2006";"6. Biased  coin";"6. Biased  coin";335;410;100;310;501;500
"2007";"2. Neyman known";"2. Neyman known";335;411;82;329;422;578
"2008";"3. RSIHR Known";"3. RSIHR Known";335;471;69;402;349;651
"2009";"4. Rosenberger known";"4. Rosenberger known";335;558;27;531;138;862
"2010";"5. Optimal adjusted";"5. Optimal adjusted";335;369;103;266;563;437
"2011";"1. Random";"1. Random";336;396;90;306;508;492
"2012";"6. Biased  coin";"6. Biased  coin";336;379;77;302;501;499
"2013";"2. Neyman known";"2. Neyman known";336;417;71;346;449;551
"2014";"3. RSIHR Known";"3. RSIHR Known";336;464;78;386;380;620
"2015";"4. Rosenberger known";"4. Rosenberger known";336;564;30;534;136;864
"2016";"5. Optimal adjusted";"5. Optimal adjusted";336;396;96;300;525;475
"2017";"1. Random";"1. Random";337;413;108;305;508;492
"2018";"6. Biased  coin";"6. Biased  coin";337;415;95;320;501;500
"2019";"2. Neyman known";"2. Neyman known";337;462;100;362;448;552
"2020";"3. RSIHR Known";"3. RSIHR Known";337;474;77;397;373;627
"2021";"4. Rosenberger known";"4. Rosenberger known";337;580;33;547;142;858
"2022";"5. Optimal adjusted";"5. Optimal adjusted";337;423;107;316;538;462
"2023";"1. Random";"1. Random";338;389;104;285;534;466
"2024";"6. Biased  coin";"6. Biased  coin";338;403;98;305;501;502
"2025";"2. Neyman known";"2. Neyman known";338;412;96;316;454;546
"2026";"3. RSIHR Known";"3. RSIHR Known";338;441;68;373;376;624
"2027";"4. Rosenberger known";"4. Rosenberger known";338;533;31;502;143;857
"2028";"5. Optimal adjusted";"5. Optimal adjusted";338;373;101;272;523;477
"2029";"1. Random";"1. Random";339;395;105;290;507;493
"2030";"6. Biased  coin";"6. Biased  coin";339;401;107;294;502;500
"2031";"2. Neyman known";"2. Neyman known";339;421;93;328;450;550
"2032";"3. RSIHR Known";"3. RSIHR Known";339;436;79;357;382;618
"2033";"4. Rosenberger known";"4. Rosenberger known";339;547;27;520;132;868
"2034";"5. Optimal adjusted";"5. Optimal adjusted";339;396;119;277;531;469
"2035";"1. Random";"1. Random";340;395;109;286;518;482
"2036";"6. Biased  coin";"6. Biased  coin";340;417;109;308;500;500
"2037";"2. Neyman known";"2. Neyman known";340;423;92;331;437;563
"2038";"3. RSIHR Known";"3. RSIHR Known";340;459;79;380;374;626
"2039";"4. Rosenberger known";"4. Rosenberger known";340;541;30;511;147;853
"2040";"5. Optimal adjusted";"5. Optimal adjusted";340;397;124;273;553;447
"2041";"1. Random";"1. Random";341;411;117;294;500;500
"2042";"6. Biased  coin";"6. Biased  coin";341;412;117;295;500;500
"2043";"2. Neyman known";"2. Neyman known";341;415;100;315;468;532
"2044";"3. RSIHR Known";"3. RSIHR Known";341;461;83;378;357;643
"2045";"4. Rosenberger known";"4. Rosenberger known";341;524;36;488;165;835
"2046";"5. Optimal adjusted";"5. Optimal adjusted";341;380;113;267;534;466
"2047";"1. Random";"1. Random";342;415;77;338;484;516
"2048";"6. Biased  coin";"6. Biased  coin";342;400;95;305;500;500
"2049";"2. Neyman known";"2. Neyman known";342;408;80;328;448;552
"2050";"3. RSIHR Known";"3. RSIHR Known";342;443;62;381;363;637
"2051";"4. Rosenberger known";"4. Rosenberger known";342;532;21;511;162;838
"2052";"5. Optimal adjusted";"5. Optimal adjusted";342;394;109;285;549;451
"2053";"1. Random";"1. Random";343;390;103;287;503;497
"2054";"6. Biased  coin";"6. Biased  coin";343;371;100;271;502;499
"2055";"2. Neyman known";"2. Neyman known";343;411;96;315;459;541
"2056";"3. RSIHR Known";"3. RSIHR Known";343;451;68;383;321;679
"2057";"4. Rosenberger known";"4. Rosenberger known";343;534;27;507;144;856
"2058";"5. Optimal adjusted";"5. Optimal adjusted";343;386;111;275;529;471
"2059";"1. Random";"1. Random";344;404;87;317;482;518
"2060";"6. Biased  coin";"6. Biased  coin";344;395;93;302;499;501
"2061";"2. Neyman known";"2. Neyman known";344;425;88;337;435;565
"2062";"3. RSIHR Known";"3. RSIHR Known";344;466;82;384;367;633
"2063";"4. Rosenberger known";"4. Rosenberger known";344;543;29;514;144;856
"2064";"5. Optimal adjusted";"5. Optimal adjusted";344;400;110;290;512;488
"2065";"1. Random";"1. Random";345;379;96;283;508;492
"2066";"6. Biased  coin";"6. Biased  coin";345;404;96;308;501;499
"2067";"2. Neyman known";"2. Neyman known";345;432;94;338;454;546
"2068";"3. RSIHR Known";"3. RSIHR Known";345;460;66;394;334;666
"2069";"4. Rosenberger known";"4. Rosenberger known";345;561;37;524;148;852
"2070";"5. Optimal adjusted";"5. Optimal adjusted";345;397;96;301;506;494
"2071";"1. Random";"1. Random";346;413;100;313;491;509
"2072";"6. Biased  coin";"6. Biased  coin";346;390;97;293;500;500
"2073";"2. Neyman known";"2. Neyman known";346;438;93;345;435;565
"2074";"3. RSIHR Known";"3. RSIHR Known";346;451;66;385;357;643
"2075";"4. Rosenberger known";"4. Rosenberger known";346;559;25;534;133;867
"2076";"5. Optimal adjusted";"5. Optimal adjusted";346;381;105;276;540;460
"2077";"1. Random";"1. Random";347;368;99;269;529;471
"2078";"6. Biased  coin";"6. Biased  coin";347;408;112;296;500;500
"2079";"2. Neyman known";"2. Neyman known";347;408;89;319;441;559
"2080";"3. RSIHR Known";"3. RSIHR Known";347;433;71;362;365;635
"2081";"4. Rosenberger known";"4. Rosenberger known";347;526;28;498;152;848
"2082";"5. Optimal adjusted";"5. Optimal adjusted";347;394;103;291;515;485
"2083";"1. Random";"1. Random";348;371;90;281;508;492
"2084";"6. Biased  coin";"6. Biased  coin";348;383;94;289;498;503
"2085";"2. Neyman known";"2. Neyman known";348;407;70;337;428;572
"2086";"3. RSIHR Known";"3. RSIHR Known";348;441;57;384;348;652
"2087";"4. Rosenberger known";"4. Rosenberger known";348;533;27;506;137;863
"2088";"5. Optimal adjusted";"5. Optimal adjusted";348;360;79;281;510;490
"2089";"1. Random";"1. Random";349;426;102;324;486;514
"2090";"6. Biased  coin";"6. Biased  coin";349;389;93;296;500;501
"2091";"2. Neyman known";"2. Neyman known";349;426;88;338;452;548
"2092";"3. RSIHR Known";"3. RSIHR Known";349;458;73;385;364;636
"2093";"4. Rosenberger known";"4. Rosenberger known";349;543;25;518;146;854
"2094";"5. Optimal adjusted";"5. Optimal adjusted";349;393;96;297;514;486
"2095";"1. Random";"1. Random";350;426;108;318;486;514
"2096";"6. Biased  coin";"6. Biased  coin";350;403;105;298;501;500
"2097";"2. Neyman known";"2. Neyman known";350;443;104;339;447;553
"2098";"3. RSIHR Known";"3. RSIHR Known";350;466;77;389;351;649
"2099";"4. Rosenberger known";"4. Rosenberger known";350;545;36;509;149;851
"2100";"5. Optimal adjusted";"5. Optimal adjusted";350;379;116;263;547;453
"2101";"1. Random";"1. Random";351;376;97;279;516;484
"2102";"6. Biased  coin";"6. Biased  coin";351;385;86;299;499;501
"2103";"2. Neyman known";"2. Neyman known";351;413;89;324;455;545
"2104";"3. RSIHR Known";"3. RSIHR Known";351;424;67;357;380;620
"2105";"4. Rosenberger known";"4. Rosenberger known";351;527;16;511;119;881
"2106";"5. Optimal adjusted";"5. Optimal adjusted";351;365;95;270;537;463
"2107";"1. Random";"1. Random";352;386;99;287;513;487
"2108";"6. Biased  coin";"6. Biased  coin";352;410;96;314;499;502
"2109";"2. Neyman known";"2. Neyman known";352;405;70;335;461;539
"2110";"3. RSIHR Known";"3. RSIHR Known";352;472;82;390;361;639
"2111";"4. Rosenberger known";"4. Rosenberger known";352;553;27;526;138;862
"2112";"5. Optimal adjusted";"5. Optimal adjusted";352;391;99;292;526;474
"2113";"1. Random";"1. Random";353;421;91;330;474;526
"2114";"6. Biased  coin";"6. Biased  coin";353;420;111;309;500;500
"2115";"2. Neyman known";"2. Neyman known";353;431;98;333;457;543
"2116";"3. RSIHR Known";"3. RSIHR Known";353;480;72;408;354;646
"2117";"4. Rosenberger known";"4. Rosenberger known";353;556;38;518;158;842
"2118";"5. Optimal adjusted";"5. Optimal adjusted";353;390;119;271;546;454
"2119";"1. Random";"1. Random";354;380;106;274;536;464
"2120";"6. Biased  coin";"6. Biased  coin";354;388;93;295;502;499
"2121";"2. Neyman known";"2. Neyman known";354;401;79;322;441;559
"2122";"3. RSIHR Known";"3. RSIHR Known";354;465;70;395;358;642
"2123";"4. Rosenberger known";"4. Rosenberger known";354;546;22;524;136;864
"2124";"5. Optimal adjusted";"5. Optimal adjusted";354;365;91;274;525;475
"2125";"1. Random";"1. Random";355;395;99;296;513;487
"2126";"6. Biased  coin";"6. Biased  coin";355;397;86;311;501;500
"2127";"2. Neyman known";"2. Neyman known";355;419;84;335;445;555
"2128";"3. RSIHR Known";"3. RSIHR Known";355;466;77;389;361;639
"2129";"4. Rosenberger known";"4. Rosenberger known";355;558;27;531;136;864
"2130";"5. Optimal adjusted";"5. Optimal adjusted";355;416;119;297;527;473
"2131";"1. Random";"1. Random";356;400;90;310;477;523
"2132";"6. Biased  coin";"6. Biased  coin";356;387;86;301;501;500
"2133";"2. Neyman known";"2. Neyman known";356;434;88;346;448;552
"2134";"3. RSIHR Known";"3. RSIHR Known";356;442;75;367;406;594
"2135";"4. Rosenberger known";"4. Rosenberger known";356;553;31;522;150;850
"2136";"5. Optimal adjusted";"5. Optimal adjusted";356;392;99;293;522;478
"2137";"1. Random";"1. Random";357;420;104;316;480;520
"2138";"6. Biased  coin";"6. Biased  coin";357;416;101;315;500;501
"2139";"2. Neyman known";"2. Neyman known";357;428;88;340;472;528
"2140";"3. RSIHR Known";"3. RSIHR Known";357;441;69;372;371;629
"2141";"4. Rosenberger known";"4. Rosenberger known";357;558;25;533;143;857
"2142";"5. Optimal adjusted";"5. Optimal adjusted";357;388;102;286;522;478
"2143";"1. Random";"1. Random";358;401;101;300;520;480
"2144";"6. Biased  coin";"6. Biased  coin";358;404;97;307;500;500
"2145";"2. Neyman known";"2. Neyman known";358;415;76;339;429;571
"2146";"3. RSIHR Known";"3. RSIHR Known";358;479;78;401;357;643
"2147";"4. Rosenberger known";"4. Rosenberger known";358;548;31;517;149;851
"2148";"5. Optimal adjusted";"5. Optimal adjusted";358;356;96;260;555;445
"2149";"1. Random";"1. Random";359;379;92;287;496;504
"2150";"6. Biased  coin";"6. Biased  coin";359;391;101;290;499;502
"2151";"2. Neyman known";"2. Neyman known";359;413;87;326;439;561
"2152";"3. RSIHR Known";"3. RSIHR Known";359;454;75;379;356;644
"2153";"4. Rosenberger known";"4. Rosenberger known";359;514;32;482;161;839
"2154";"5. Optimal adjusted";"5. Optimal adjusted";359;358;101;257;532;468
"2155";"1. Random";"1. Random";360;396;105;291;504;496
"2156";"6. Biased  coin";"6. Biased  coin";360;381;94;287;500;501
"2157";"2. Neyman known";"2. Neyman known";360;402;89;313;467;533
"2158";"3. RSIHR Known";"3. RSIHR Known";360;432;70;362;382;618
"2159";"4. Rosenberger known";"4. Rosenberger known";360;550;40;510;130;870
"2160";"5. Optimal adjusted";"5. Optimal adjusted";360;389;113;276;527;473
"2161";"1. Random";"1. Random";361;385;89;296;495;505
"2162";"6. Biased  coin";"6. Biased  coin";361;384;92;292;500;502
"2163";"2. Neyman known";"2. Neyman known";361;409;80;329;430;570
"2164";"3. RSIHR Known";"3. RSIHR Known";361;428;62;366;369;631
"2165";"4. Rosenberger known";"4. Rosenberger known";361;520;25;495;155;845
"2166";"5. Optimal adjusted";"5. Optimal adjusted";361;382;99;283;527;473
"2167";"1. Random";"1. Random";362;401;103;298;503;497
"2168";"6. Biased  coin";"6. Biased  coin";362;388;103;285;502;499
"2169";"2. Neyman known";"2. Neyman known";362;430;96;334;439;561
"2170";"3. RSIHR Known";"3. RSIHR Known";362;467;92;375;377;623
"2171";"4. Rosenberger known";"4. Rosenberger known";362;535;30;505;150;850
"2172";"5. Optimal adjusted";"5. Optimal adjusted";362;388;115;273;536;464
"2173";"1. Random";"1. Random";363;398;105;293;487;513
"2174";"6. Biased  coin";"6. Biased  coin";363;400;101;299;499;501
"2175";"2. Neyman known";"2. Neyman known";363;412;88;324;458;542
"2176";"3. RSIHR Known";"3. RSIHR Known";363;465;68;397;356;644
"2177";"4. Rosenberger known";"4. Rosenberger known";363;565;30;535;144;856
"2178";"5. Optimal adjusted";"5. Optimal adjusted";363;385;106;279;555;445
"2179";"1. Random";"1. Random";364;379;106;273;564;436
"2180";"6. Biased  coin";"6. Biased  coin";364;401;100;301;500;500
"2181";"2. Neyman known";"2. Neyman known";364;419;92;327;471;529
"2182";"3. RSIHR Known";"3. RSIHR Known";364;462;66;396;352;648
"2183";"4. Rosenberger known";"4. Rosenberger known";364;557;32;525;128;872
"2184";"5. Optimal adjusted";"5. Optimal adjusted";364;381;105;276;530;470
"2185";"1. Random";"1. Random";365;426;108;318;499;501
"2186";"6. Biased  coin";"6. Biased  coin";365;425;111;314;503;499
"2187";"2. Neyman known";"2. Neyman known";365;452;106;346;446;554
"2188";"3. RSIHR Known";"3. RSIHR Known";365;477;65;412;341;659
"2189";"4. Rosenberger known";"4. Rosenberger known";365;572;31;541;137;863
"2190";"5. Optimal adjusted";"5. Optimal adjusted";365;408;124;284;546;454
"2191";"1. Random";"1. Random";366;421;119;302;510;490
"2192";"6. Biased  coin";"6. Biased  coin";366;409;114;295;500;500
"2193";"2. Neyman known";"2. Neyman known";366;416;108;308;483;517
"2194";"3. RSIHR Known";"3. RSIHR Known";366;444;69;375;359;641
"2195";"4. Rosenberger known";"4. Rosenberger known";366;540;31;509;138;862
"2196";"5. Optimal adjusted";"5. Optimal adjusted";366;365;108;257;559;441
"2197";"1. Random";"1. Random";367;373;99;274;534;466
"2198";"6. Biased  coin";"6. Biased  coin";367;401;98;303;505;500
"2199";"2. Neyman known";"2. Neyman known";367;412;83;329;445;555
"2200";"3. RSIHR Known";"3. RSIHR Known";367;441;71;370;383;617
"2201";"4. Rosenberger known";"4. Rosenberger known";367;537;32;505;152;848
"2202";"5. Optimal adjusted";"5. Optimal adjusted";367;380;92;288;524;476
"2203";"1. Random";"1. Random";368;396;94;302;503;497
"2204";"6. Biased  coin";"6. Biased  coin";368;413;98;315;503;498
"2205";"2. Neyman known";"2. Neyman known";368;395;76;319;459;541
"2206";"3. RSIHR Known";"3. RSIHR Known";368;444;60;384;371;629
"2207";"4. Rosenberger known";"4. Rosenberger known";368;555;30;525;141;859
"2208";"5. Optimal adjusted";"5. Optimal adjusted";368;377;104;273;550;450
"2209";"1. Random";"1. Random";369;402;113;289;501;499
"2210";"6. Biased  coin";"6. Biased  coin";369;410;110;300;505;499
"2211";"2. Neyman known";"2. Neyman known";369;431;103;328;449;551
"2212";"3. RSIHR Known";"3. RSIHR Known";369;454;85;369;377;623
"2213";"4. Rosenberger known";"4. Rosenberger known";369;551;22;529;124;876
"2214";"5. Optimal adjusted";"5. Optimal adjusted";369;397;124;273;537;463
"2215";"1. Random";"1. Random";370;376;99;277;528;472
"2216";"6. Biased  coin";"6. Biased  coin";370;381;87;294;497;504
"2217";"2. Neyman known";"2. Neyman known";370;424;84;340;448;552
"2218";"3. RSIHR Known";"3. RSIHR Known";370;446;62;384;359;641
"2219";"4. Rosenberger known";"4. Rosenberger known";370;537;18;519;131;869
"2220";"5. Optimal adjusted";"5. Optimal adjusted";370;371;96;275;530;470
"2221";"1. Random";"1. Random";371;375;96;279;504;496
"2222";"6. Biased  coin";"6. Biased  coin";371;378;94;284;500;501
"2223";"2. Neyman known";"2. Neyman known";371;415;86;329;443;557
"2224";"3. RSIHR Known";"3. RSIHR Known";371;441;56;385;342;658
"2225";"4. Rosenberger known";"4. Rosenberger known";371;531;30;501;151;849
"2226";"5. Optimal adjusted";"5. Optimal adjusted";371;380;120;260;552;448
"2227";"1. Random";"1. Random";372;416;111;305;531;469
"2228";"6. Biased  coin";"6. Biased  coin";372;401;99;302;499;502
"2229";"2. Neyman known";"2. Neyman known";372;459;95;364;430;570
"2230";"3. RSIHR Known";"3. RSIHR Known";372;459;66;393;370;630
"2231";"4. Rosenberger known";"4. Rosenberger known";372;562;26;536;128;872
"2232";"5. Optimal adjusted";"5. Optimal adjusted";372;401;95;306;520;480
"2233";"1. Random";"1. Random";373;403;101;302;504;496
"2234";"6. Biased  coin";"6. Biased  coin";373;411;99;312;501;500
"2235";"2. Neyman known";"2. Neyman known";373;414;88;326;455;545
"2236";"3. RSIHR Known";"3. RSIHR Known";373;452;57;395;361;639
"2237";"4. Rosenberger known";"4. Rosenberger known";373;539;24;515;151;849
"2238";"5. Optimal adjusted";"5. Optimal adjusted";373;386;103;283;535;465
"2239";"1. Random";"1. Random";374;394;99;295;509;491
"2240";"6. Biased  coin";"6. Biased  coin";374;420;101;319;500;500
"2241";"2. Neyman known";"2. Neyman known";374;427;82;345;441;559
"2242";"3. RSIHR Known";"3. RSIHR Known";374;447;67;380;350;650
"2243";"4. Rosenberger known";"4. Rosenberger known";374;535;38;497;153;847
"2244";"5. Optimal adjusted";"5. Optimal adjusted";374;363;104;259;563;437
"2245";"1. Random";"1. Random";375;400;105;295;497;503
"2246";"6. Biased  coin";"6. Biased  coin";375;411;106;305;500;500
"2247";"2. Neyman known";"2. Neyman known";375;407;76;331;442;558
"2248";"3. RSIHR Known";"3. RSIHR Known";375;444;71;373;381;619
"2249";"4. Rosenberger known";"4. Rosenberger known";375;548;32;516;149;851
"2250";"5. Optimal adjusted";"5. Optimal adjusted";375;363;105;258;533;467
"2251";"1. Random";"1. Random";376;424;103;321;479;521
"2252";"6. Biased  coin";"6. Biased  coin";376;415;94;321;500;500
"2253";"2. Neyman known";"2. Neyman known";376;443;80;363;447;553
"2254";"3. RSIHR Known";"3. RSIHR Known";376;462;81;381;394;606
"2255";"4. Rosenberger known";"4. Rosenberger known";376;559;23;536;136;864
"2256";"5. Optimal adjusted";"5. Optimal adjusted";376;388;98;290;520;480
"2257";"1. Random";"1. Random";377;411;115;296;527;473
"2258";"6. Biased  coin";"6. Biased  coin";377;396;103;293;500;500
"2259";"2. Neyman known";"2. Neyman known";377;431;79;352;415;585
"2260";"3. RSIHR Known";"3. RSIHR Known";377;463;66;397;370;630
"2261";"4. Rosenberger known";"4. Rosenberger known";377;550;26;524;144;856
"2262";"5. Optimal adjusted";"5. Optimal adjusted";377;367;92;275;538;462
"2263";"1. Random";"1. Random";378;425;100;325;483;517
"2264";"6. Biased  coin";"6. Biased  coin";378;401;94;307;502;499
"2265";"2. Neyman known";"2. Neyman known";378;427;88;339;438;562
"2266";"3. RSIHR Known";"3. RSIHR Known";378;484;71;413;360;640
"2267";"4. Rosenberger known";"4. Rosenberger known";378;557;28;529;154;846
"2268";"5. Optimal adjusted";"5. Optimal adjusted";378;398;115;283;543;457
"2269";"1. Random";"1. Random";379;427;112;315;493;507
"2270";"6. Biased  coin";"6. Biased  coin";379;405;111;294;502;498
"2271";"2. Neyman known";"2. Neyman known";379;410;89;321;449;551
"2272";"3. RSIHR Known";"3. RSIHR Known";379;448;78;370;371;629
"2273";"4. Rosenberger known";"4. Rosenberger known";379;555;24;531;127;873
"2274";"5. Optimal adjusted";"5. Optimal adjusted";379;379;121;258;575;425
"2275";"1. Random";"1. Random";380;402;96;306;512;488
"2276";"6. Biased  coin";"6. Biased  coin";380;397;96;301;499;501
"2277";"2. Neyman known";"2. Neyman known";380;432;103;329;463;537
"2278";"3. RSIHR Known";"3. RSIHR Known";380;448;68;380;363;637
"2279";"4. Rosenberger known";"4. Rosenberger known";380;539;33;506;156;844
"2280";"5. Optimal adjusted";"5. Optimal adjusted";380;388;101;287;530;470
"2281";"1. Random";"1. Random";381;409;98;311;492;508
"2282";"6. Biased  coin";"6. Biased  coin";381;393;102;291;501;499
"2283";"2. Neyman known";"2. Neyman known";381;407;87;320;467;533
"2284";"3. RSIHR Known";"3. RSIHR Known";381;458;71;387;368;632
"2285";"4. Rosenberger known";"4. Rosenberger known";381;544;20;524;127;873
"2286";"5. Optimal adjusted";"5. Optimal adjusted";381;385;101;284;530;470
"2287";"1. Random";"1. Random";382;410;94;316;486;514
"2288";"6. Biased  coin";"6. Biased  coin";382;426;104;322;500;500
"2289";"2. Neyman known";"2. Neyman known";382;420;85;335;427;573
"2290";"3. RSIHR Known";"3. RSIHR Known";382;466;75;391;363;637
"2291";"4. Rosenberger known";"4. Rosenberger known";382;563;34;529;135;865
"2292";"5. Optimal adjusted";"5. Optimal adjusted";382;385;100;285;516;484
"2293";"1. Random";"1. Random";383;408;107;301;505;495
"2294";"6. Biased  coin";"6. Biased  coin";383;401;105;296;499;501
"2295";"2. Neyman known";"2. Neyman known";383;442;82;360;417;583
"2296";"3. RSIHR Known";"3. RSIHR Known";383;486;76;410;343;657
"2297";"4. Rosenberger known";"4. Rosenberger known";383;555;26;529;146;854
"2298";"5. Optimal adjusted";"5. Optimal adjusted";383;379;111;268;568;432
"2299";"1. Random";"1. Random";384;388;111;277;533;467
"2300";"6. Biased  coin";"6. Biased  coin";384;410;111;299;500;501
"2301";"2. Neyman known";"2. Neyman known";384;405;92;313;444;556
"2302";"3. RSIHR Known";"3. RSIHR Known";384;442;79;363;389;611
"2303";"4. Rosenberger known";"4. Rosenberger known";384;536;23;513;126;874
"2304";"5. Optimal adjusted";"5. Optimal adjusted";384;383;120;263;547;453
"2305";"1. Random";"1. Random";385;417;93;324;476;524
"2306";"6. Biased  coin";"6. Biased  coin";385;387;97;290;501;500
"2307";"2. Neyman known";"2. Neyman known";385;404;83;321;451;549
"2308";"3. RSIHR Known";"3. RSIHR Known";385;434;71;363;382;618
"2309";"4. Rosenberger known";"4. Rosenberger known";385;528;25;503;140;860
"2310";"5. Optimal adjusted";"5. Optimal adjusted";385;354;87;267;532;468
"2311";"1. Random";"1. Random";386;393;86;307;496;504
"2312";"6. Biased  coin";"6. Biased  coin";386;401;96;305;501;499
"2313";"2. Neyman known";"2. Neyman known";386;424;89;335;439;561
"2314";"3. RSIHR Known";"3. RSIHR Known";386;470;69;401;365;635
"2315";"4. Rosenberger known";"4. Rosenberger known";386;561;30;531;150;850
"2316";"5. Optimal adjusted";"5. Optimal adjusted";386;404;113;291;549;451
"2317";"1. Random";"1. Random";387;377;94;283;500;500
"2318";"6. Biased  coin";"6. Biased  coin";387;393;96;297;501;499
"2319";"2. Neyman known";"2. Neyman known";387;429;91;338;439;561
"2320";"3. RSIHR Known";"3. RSIHR Known";387;453;69;384;384;616
"2321";"4. Rosenberger known";"4. Rosenberger known";387;540;33;507;151;849
"2322";"5. Optimal adjusted";"5. Optimal adjusted";387;385;104;281;534;466
"2323";"1. Random";"1. Random";388;401;112;289;540;460
"2324";"6. Biased  coin";"6. Biased  coin";388;398;95;303;500;500
"2325";"2. Neyman known";"2. Neyman known";388;429;80;349;436;564
"2326";"3. RSIHR Known";"3. RSIHR Known";388;444;66;378;371;629
"2327";"4. Rosenberger known";"4. Rosenberger known";388;553;26;527;137;863
"2328";"5. Optimal adjusted";"5. Optimal adjusted";388;374;90;284;528;472
"2329";"1. Random";"1. Random";389;370;87;283;501;499
"2330";"6. Biased  coin";"6. Biased  coin";389;389;92;297;498;502
"2331";"2. Neyman known";"2. Neyman known";389;409;78;331;442;558
"2332";"3. RSIHR Known";"3. RSIHR Known";389;442;64;378;353;647
"2333";"4. Rosenberger known";"4. Rosenberger known";389;536;36;500;158;842
"2334";"5. Optimal adjusted";"5. Optimal adjusted";389;368;93;275;543;457
"2335";"1. Random";"1. Random";390;387;99;288;519;481
"2336";"6. Biased  coin";"6. Biased  coin";390;402;101;301;505;497
"2337";"2. Neyman known";"2. Neyman known";390;432;94;338;445;555
"2338";"3. RSIHR Known";"3. RSIHR Known";390;438;66;372;378;622
"2339";"4. Rosenberger known";"4. Rosenberger known";390;553;28;525;139;861
"2340";"5. Optimal adjusted";"5. Optimal adjusted";390;396;99;297;506;494
"2341";"1. Random";"1. Random";391;402;90;312;474;526
"2342";"6. Biased  coin";"6. Biased  coin";391;414;105;309;500;500
"2343";"2. Neyman known";"2. Neyman known";391;429;94;335;458;542
"2344";"3. RSIHR Known";"3. RSIHR Known";391;473;74;399;358;642
"2345";"4. Rosenberger known";"4. Rosenberger known";391;550;39;511;142;858
"2346";"5. Optimal adjusted";"5. Optimal adjusted";391;371;106;265;565;435
"2347";"1. Random";"1. Random";392;401;94;307;494;506
"2348";"6. Biased  coin";"6. Biased  coin";392;391;96;295;501;501
"2349";"2. Neyman known";"2. Neyman known";392;425;92;333;438;562
"2350";"3. RSIHR Known";"3. RSIHR Known";392;460;67;393;354;646
"2351";"4. Rosenberger known";"4. Rosenberger known";392;549;28;521;131;869
"2352";"5. Optimal adjusted";"5. Optimal adjusted";392;380;106;274;535;465
"2353";"1. Random";"1. Random";393;412;104;308;498;502
"2354";"6. Biased  coin";"6. Biased  coin";393;427;120;307;499;501
"2355";"2. Neyman known";"2. Neyman known";393;438;97;341;443;557
"2356";"3. RSIHR Known";"3. RSIHR Known";393;479;82;397;338;662
"2357";"4. Rosenberger known";"4. Rosenberger known";393;567;31;536;116;884
"2358";"5. Optimal adjusted";"5. Optimal adjusted";393;417;114;303;499;501
"2359";"1. Random";"1. Random";394;415;114;301;517;483
"2360";"6. Biased  coin";"6. Biased  coin";394;401;97;304;501;499
"2361";"2. Neyman known";"2. Neyman known";394;431;85;346;441;559
"2362";"3. RSIHR Known";"3. RSIHR Known";394;455;72;383;363;637
"2363";"4. Rosenberger known";"4. Rosenberger known";394;555;23;532;138;862
"2364";"5. Optimal adjusted";"5. Optimal adjusted";394;401;117;284;536;464
"2365";"1. Random";"1. Random";395;397;106;291;510;490
"2366";"6. Biased  coin";"6. Biased  coin";395;406;115;291;499;502
"2367";"2. Neyman known";"2. Neyman known";395;407;89;318;457;543
"2368";"3. RSIHR Known";"3. RSIHR Known";395;467;68;399;328;672
"2369";"4. Rosenberger known";"4. Rosenberger known";395;556;32;524;142;858
"2370";"5. Optimal adjusted";"5. Optimal adjusted";395;394;104;290;518;482
"2371";"1. Random";"1. Random";396;410;99;311;491;509
"2372";"6. Biased  coin";"6. Biased  coin";396;434;111;323;501;500
"2373";"2. Neyman known";"2. Neyman known";396;410;90;320;475;525
"2374";"3. RSIHR Known";"3. RSIHR Known";396;454;75;379;364;636
"2375";"4. Rosenberger known";"4. Rosenberger known";396;557;27;530;140;860
"2376";"5. Optimal adjusted";"5. Optimal adjusted";396;393;109;284;545;455
"2377";"1. Random";"1. Random";397;390;92;298;478;522
"2378";"6. Biased  coin";"6. Biased  coin";397;388;91;297;502;500
"2379";"2. Neyman known";"2. Neyman known";397;397;86;311;465;535
"2380";"3. RSIHR Known";"3. RSIHR Known";397;459;67;392;351;649
"2381";"4. Rosenberger known";"4. Rosenberger known";397;522;18;504;139;861
"2382";"5. Optimal adjusted";"5. Optimal adjusted";397;366;99;267;539;461
"2383";"1. Random";"1. Random";398;425;101;324;470;530
"2384";"6. Biased  coin";"6. Biased  coin";398;406;105;301;500;500
"2385";"2. Neyman known";"2. Neyman known";398;425;98;327;458;542
"2386";"3. RSIHR Known";"3. RSIHR Known";398;458;69;389;359;641
"2387";"4. Rosenberger known";"4. Rosenberger known";398;541;32;509;157;843
"2388";"5. Optimal adjusted";"5. Optimal adjusted";398;395;108;287;535;465
"2389";"1. Random";"1. Random";399;425;99;326;472;528
"2390";"6. Biased  coin";"6. Biased  coin";399;403;97;306;503;499
"2391";"2. Neyman known";"2. Neyman known";399;422;98;324;481;519
"2392";"3. RSIHR Known";"3. RSIHR Known";399;454;86;368;390;610
"2393";"4. Rosenberger known";"4. Rosenberger known";399;539;29;510;155;845
"2394";"5. Optimal adjusted";"5. Optimal adjusted";399;380;105;275;539;461
"2395";"1. Random";"1. Random";400;413;106;307;504;496
"2396";"6. Biased  coin";"6. Biased  coin";400;386;81;305;501;500
"2397";"2. Neyman known";"2. Neyman known";400;418;85;333;447;553
"2398";"3. RSIHR Known";"3. RSIHR Known";400;455;64;391;361;639
"2399";"4. Rosenberger known";"4. Rosenberger known";400;558;25;533;129;871
"2400";"5. Optimal adjusted";"5. Optimal adjusted";400;391;113;278;567;433
"2401";"1. Random";"1. Random";401;398;98;300;507;493
"2402";"6. Biased  coin";"6. Biased  coin";401;430;112;318;502;498
"2403";"2. Neyman known";"2. Neyman known";401;420;94;326;479;521
"2404";"3. RSIHR Known";"3. RSIHR Known";401;463;71;392;355;645
"2405";"4. Rosenberger known";"4. Rosenberger known";401;544;35;509;166;834
"2406";"5. Optimal adjusted";"5. Optimal adjusted";401;405;97;308;513;487
"2407";"1. Random";"1. Random";402;408;100;308;483;517
"2408";"6. Biased  coin";"6. Biased  coin";402;418;115;303;501;501
"2409";"2. Neyman known";"2. Neyman known";402;407;86;321;453;547
"2410";"3. RSIHR Known";"3. RSIHR Known";402;455;70;385;354;646
"2411";"4. Rosenberger known";"4. Rosenberger known";402;557;32;525;144;856
"2412";"5. Optimal adjusted";"5. Optimal adjusted";402;405;105;300;517;483
"2413";"1. Random";"1. Random";403;407;104;303;492;508
"2414";"6. Biased  coin";"6. Biased  coin";403;411;110;301;505;499
"2415";"2. Neyman known";"2. Neyman known";403;431;100;331;456;544
"2416";"3. RSIHR Known";"3. RSIHR Known";403;443;70;373;380;620
"2417";"4. Rosenberger known";"4. Rosenberger known";403;557;25;532;141;859
"2418";"5. Optimal adjusted";"5. Optimal adjusted";403;398;110;288;508;492
"2419";"1. Random";"1. Random";404;413;102;311;498;502
"2420";"6. Biased  coin";"6. Biased  coin";404;408;109;299;502;500
"2421";"2. Neyman known";"2. Neyman known";404;403;83;320;466;534
"2422";"3. RSIHR Known";"3. RSIHR Known";404;474;88;386;358;642
"2423";"4. Rosenberger known";"4. Rosenberger known";404;547;33;514;129;871
"2424";"5. Optimal adjusted";"5. Optimal adjusted";404;390;117;273;549;451
"2425";"1. Random";"1. Random";405;440;119;321;480;520
"2426";"6. Biased  coin";"6. Biased  coin";405;414;108;306;501;500
"2427";"2. Neyman known";"2. Neyman known";405;442;103;339;458;542
"2428";"3. RSIHR Known";"3. RSIHR Known";405;463;84;379;365;635
"2429";"4. Rosenberger known";"4. Rosenberger known";405;558;26;532;137;863
"2430";"5. Optimal adjusted";"5. Optimal adjusted";405;412;113;299;519;481
"2431";"1. Random";"1. Random";406;384;96;288;513;487
"2432";"6. Biased  coin";"6. Biased  coin";406;397;98;299;502;500
"2433";"2. Neyman known";"2. Neyman known";406;423;90;333;447;553
"2434";"3. RSIHR Known";"3. RSIHR Known";406;422;64;358;374;626
"2435";"4. Rosenberger known";"4. Rosenberger known";406;536;28;508;148;852
"2436";"5. Optimal adjusted";"5. Optimal adjusted";406;372;112;260;562;438
"2437";"1. Random";"1. Random";407;374;89;285;496;504
"2438";"6. Biased  coin";"6. Biased  coin";407;381;88;293;501;500
"2439";"2. Neyman known";"2. Neyman known";407;414;77;337;420;580
"2440";"3. RSIHR Known";"3. RSIHR Known";407;447;71;376;359;641
"2441";"4. Rosenberger known";"4. Rosenberger known";407;527;34;493;150;850
"2442";"5. Optimal adjusted";"5. Optimal adjusted";407;378;99;279;537;463
"2443";"1. Random";"1. Random";408;408;107;301;510;490
"2444";"6. Biased  coin";"6. Biased  coin";408;407;114;293;503;497
"2445";"2. Neyman known";"2. Neyman known";408;422;94;328;453;547
"2446";"3. RSIHR Known";"3. RSIHR Known";408;478;73;405;352;648
"2447";"4. Rosenberger known";"4. Rosenberger known";408;547;30;517;136;864
"2448";"5. Optimal adjusted";"5. Optimal adjusted";408;384;102;282;533;467
"2449";"1. Random";"1. Random";409;418;116;302;512;488
"2450";"6. Biased  coin";"6. Biased  coin";409;397;94;303;501;500
"2451";"2. Neyman known";"2. Neyman known";409;445;87;358;446;554
"2452";"3. RSIHR Known";"3. RSIHR Known";409;451;71;380;376;624
"2453";"4. Rosenberger known";"4. Rosenberger known";409;565;32;533;147;853
"2454";"5. Optimal adjusted";"5. Optimal adjusted";409;394;118;276;566;434
"2455";"1. Random";"1. Random";410;436;99;337;478;522
"2456";"6. Biased  coin";"6. Biased  coin";410;417;104;313;501;499
"2457";"2. Neyman known";"2. Neyman known";410;403;90;313;457;543
"2458";"3. RSIHR Known";"3. RSIHR Known";410;471;81;390;374;626
"2459";"4. Rosenberger known";"4. Rosenberger known";410;538;26;512;135;865
"2460";"5. Optimal adjusted";"5. Optimal adjusted";410;370;113;257;550;450
"2461";"1. Random";"1. Random";411;414;99;315;497;503
"2462";"6. Biased  coin";"6. Biased  coin";411;400;93;307;500;500
"2463";"2. Neyman known";"2. Neyman known";411;425;98;327;486;514
"2464";"3. RSIHR Known";"3. RSIHR Known";411;463;71;392;364;636
"2465";"4. Rosenberger known";"4. Rosenberger known";411;578;31;547;143;857
"2466";"5. Optimal adjusted";"5. Optimal adjusted";411;392;108;284;524;476
"2467";"1. Random";"1. Random";412;393;102;291;512;488
"2468";"6. Biased  coin";"6. Biased  coin";412;400;100;300;502;499
"2469";"2. Neyman known";"2. Neyman known";412;428;83;345;449;551
"2470";"3. RSIHR Known";"3. RSIHR Known";412;437;59;378;359;641
"2471";"4. Rosenberger known";"4. Rosenberger known";412;546;31;515;145;855
"2472";"5. Optimal adjusted";"5. Optimal adjusted";412;369;93;276;537;463
"2473";"1. Random";"1. Random";413;413;103;310;487;513
"2474";"6. Biased  coin";"6. Biased  coin";413;392;93;299;500;500
"2475";"2. Neyman known";"2. Neyman known";413;409;90;319;454;546
"2476";"3. RSIHR Known";"3. RSIHR Known";413;443;69;374;388;612
"2477";"4. Rosenberger known";"4. Rosenberger known";413;535;26;509;148;852
"2478";"5. Optimal adjusted";"5. Optimal adjusted";413;360;93;267;535;465
"2479";"1. Random";"1. Random";414;420;106;314;495;505
"2480";"6. Biased  coin";"6. Biased  coin";414;382;82;300;504;499
"2481";"2. Neyman known";"2. Neyman known";414;442;86;356;440;560
"2482";"3. RSIHR Known";"3. RSIHR Known";414;463;62;401;344;656
"2483";"4. Rosenberger known";"4. Rosenberger known";414;557;23;534;116;884
"2484";"5. Optimal adjusted";"5. Optimal adjusted";414;376;95;281;509;491
"2485";"1. Random";"1. Random";415;406;79;327;449;551
"2486";"6. Biased  coin";"6. Biased  coin";415;394;101;293;501;499
"2487";"2. Neyman known";"2. Neyman known";415;417;70;347;422;578
"2488";"3. RSIHR Known";"3. RSIHR Known";415;433;73;360;381;619
"2489";"4. Rosenberger known";"4. Rosenberger known";415;541;33;508;152;848
"2490";"5. Optimal adjusted";"5. Optimal adjusted";415;392;114;278;541;459
"2491";"1. Random";"1. Random";416;385;99;286;529;471
"2492";"6. Biased  coin";"6. Biased  coin";416;407;96;311;500;500
"2493";"2. Neyman known";"2. Neyman known";416;432;85;347;450;550
"2494";"3. RSIHR Known";"3. RSIHR Known";416;470;72;398;381;619
"2495";"4. Rosenberger known";"4. Rosenberger known";416;547;28;519;150;850
"2496";"5. Optimal adjusted";"5. Optimal adjusted";416;378;100;278;548;452
"2497";"1. Random";"1. Random";417;406;100;306;491;509
"2498";"6. Biased  coin";"6. Biased  coin";417;419;108;311;500;500
"2499";"2. Neyman known";"2. Neyman known";417;443;97;346;445;555
"2500";"3. RSIHR Known";"3. RSIHR Known";417;456;73;383;371;629
"2501";"4. Rosenberger known";"4. Rosenberger known";417;572;37;535;135;865
"2502";"5. Optimal adjusted";"5. Optimal adjusted";417;393;115;278;541;459
"2503";"1. Random";"1. Random";418;430;106;324;481;519
"2504";"6. Biased  coin";"6. Biased  coin";418;416;103;313;499;501
"2505";"2. Neyman known";"2. Neyman known";418;431;97;334;468;532
"2506";"3. RSIHR Known";"3. RSIHR Known";418;468;69;399;340;660
"2507";"4. Rosenberger known";"4. Rosenberger known";418;543;28;515;134;866
"2508";"5. Optimal adjusted";"5. Optimal adjusted";418;386;119;267;529;471
"2509";"1. Random";"1. Random";419;373;100;273;501;499
"2510";"6. Biased  coin";"6. Biased  coin";419;379;95;284;502;500
"2511";"2. Neyman known";"2. Neyman known";419;409;89;320;463;537
"2512";"3. RSIHR Known";"3. RSIHR Known";419;446;69;377;361;639
"2513";"4. Rosenberger known";"4. Rosenberger known";419;527;29;498;142;858
"2514";"5. Optimal adjusted";"5. Optimal adjusted";419;382;103;279;524;476
"2515";"1. Random";"1. Random";420;395;89;306;512;488
"2516";"6. Biased  coin";"6. Biased  coin";420;395;97;298;500;501
"2517";"2. Neyman known";"2. Neyman known";420;398;75;323;453;547
"2518";"3. RSIHR Known";"3. RSIHR Known";420;445;62;383;355;645
"2519";"4. Rosenberger known";"4. Rosenberger known";420;540;30;510;154;846
"2520";"5. Optimal adjusted";"5. Optimal adjusted";420;397;105;292;526;474
"2521";"1. Random";"1. Random";421;413;101;312;506;494
"2522";"6. Biased  coin";"6. Biased  coin";421;423;114;309;499;501
"2523";"2. Neyman known";"2. Neyman known";421;427;86;341;428;572
"2524";"3. RSIHR Known";"3. RSIHR Known";421;441;70;371;377;623
"2525";"4. Rosenberger known";"4. Rosenberger known";421;547;23;524;130;870
"2526";"5. Optimal adjusted";"5. Optimal adjusted";421;386;112;274;550;450
"2527";"1. Random";"1. Random";422;420;92;328;477;523
"2528";"6. Biased  coin";"6. Biased  coin";422;403;99;304;501;500
"2529";"2. Neyman known";"2. Neyman known";422;441;101;340;462;538
"2530";"3. RSIHR Known";"3. RSIHR Known";422;459;68;391;357;643
"2531";"4. Rosenberger known";"4. Rosenberger known";422;565;30;535;137;863
"2532";"5. Optimal adjusted";"5. Optimal adjusted";422;389;110;279;557;443
"2533";"1. Random";"1. Random";423;389;86;303;506;494
"2534";"6. Biased  coin";"6. Biased  coin";423;405;88;317;500;500
"2535";"2. Neyman known";"2. Neyman known";423;412;81;331;465;535
"2536";"3. RSIHR Known";"3. RSIHR Known";423;450;68;382;371;629
"2537";"4. Rosenberger known";"4. Rosenberger known";423;556;22;534;135;865
"2538";"5. Optimal adjusted";"5. Optimal adjusted";423;380;83;297;509;491
"2539";"1. Random";"1. Random";424;387;89;298;488;512
"2540";"6. Biased  coin";"6. Biased  coin";424;378;90;288;501;500
"2541";"2. Neyman known";"2. Neyman known";424;429;77;352;417;583
"2542";"3. RSIHR Known";"3. RSIHR Known";424;464;67;397;344;656
"2543";"4. Rosenberger known";"4. Rosenberger known";424;532;28;504;151;849
"2544";"5. Optimal adjusted";"5. Optimal adjusted";424;358;96;262;562;438
"2545";"1. Random";"1. Random";425;395;98;297;469;531
"2546";"6. Biased  coin";"6. Biased  coin";425;415;119;296;500;500
"2547";"2. Neyman known";"2. Neyman known";425;422;86;336;415;585
"2548";"3. RSIHR Known";"3. RSIHR Known";425;448;85;363;376;624
"2549";"4. Rosenberger known";"4. Rosenberger known";425;528;32;496;143;857
"2550";"5. Optimal adjusted";"5. Optimal adjusted";425;385;126;259;552;448
"2551";"1. Random";"1. Random";426;403;91;312;480;520
"2552";"6. Biased  coin";"6. Biased  coin";426;410;100;310;499;501
"2553";"2. Neyman known";"2. Neyman known";426;430;98;332;460;540
"2554";"3. RSIHR Known";"3. RSIHR Known";426;482;75;407;348;652
"2555";"4. Rosenberger known";"4. Rosenberger known";426;547;27;520;145;855
"2556";"5. Optimal adjusted";"5. Optimal adjusted";426;389;110;279;534;466
"2557";"1. Random";"1. Random";427;379;91;288;521;479
"2558";"6. Biased  coin";"6. Biased  coin";427;415;101;314;503;498
"2559";"2. Neyman known";"2. Neyman known";427;428;90;338;448;552
"2560";"3. RSIHR Known";"3. RSIHR Known";427;440;78;362;393;607
"2561";"4. Rosenberger known";"4. Rosenberger known";427;536;25;511;151;849
"2562";"5. Optimal adjusted";"5. Optimal adjusted";427;406;108;298;526;474
"2563";"1. Random";"1. Random";428;428;108;320;493;507
"2564";"6. Biased  coin";"6. Biased  coin";428;406;100;306;500;500
"2565";"2. Neyman known";"2. Neyman known";428;439;99;340;471;529
"2566";"3. RSIHR Known";"3. RSIHR Known";428;470;69;401;357;643
"2567";"4. Rosenberger known";"4. Rosenberger known";428;543;30;513;175;825
"2568";"5. Optimal adjusted";"5. Optimal adjusted";428;396;103;293;522;478
"2569";"1. Random";"1. Random";429;419;115;304;508;492
"2570";"6. Biased  coin";"6. Biased  coin";429;408;102;306;503;499
"2571";"2. Neyman known";"2. Neyman known";429;441;85;356;436;564
"2572";"3. RSIHR Known";"3. RSIHR Known";429;488;87;401;368;632
"2573";"4. Rosenberger known";"4. Rosenberger known";429;561;27;534;141;859
"2574";"5. Optimal adjusted";"5. Optimal adjusted";429;394;105;289;525;475
"2575";"1. Random";"1. Random";430;413;90;323;462;538
"2576";"6. Biased  coin";"6. Biased  coin";430;384;85;299;502;499
"2577";"2. Neyman known";"2. Neyman known";430;411;83;328;467;533
"2578";"3. RSIHR Known";"3. RSIHR Known";430;461;71;390;357;643
"2579";"4. Rosenberger known";"4. Rosenberger known";430;546;31;515;158;842
"2580";"5. Optimal adjusted";"5. Optimal adjusted";430;382;98;284;524;476
"2581";"1. Random";"1. Random";431;380;93;287;495;505
"2582";"6. Biased  coin";"6. Biased  coin";431;384;96;288;502;499
"2583";"2. Neyman known";"2. Neyman known";431;404;81;323;445;555
"2584";"3. RSIHR Known";"3. RSIHR Known";431;457;73;384;362;638
"2585";"4. Rosenberger known";"4. Rosenberger known";431;536;29;507;145;855
"2586";"5. Optimal adjusted";"5. Optimal adjusted";431;384;96;288;511;489
"2587";"1. Random";"1. Random";432;385;91;294;513;487
"2588";"6. Biased  coin";"6. Biased  coin";432;412;104;308;504;498
"2589";"2. Neyman known";"2. Neyman known";432;427;90;337;456;544
"2590";"3. RSIHR Known";"3. RSIHR Known";432;473;76;397;351;649
"2591";"4. Rosenberger known";"4. Rosenberger known";432;553;23;530;140;860
"2592";"5. Optimal adjusted";"5. Optimal adjusted";432;374;100;274;562;438
"2593";"1. Random";"1. Random";433;401;102;299;507;493
"2594";"6. Biased  coin";"6. Biased  coin";433;420;99;321;501;500
"2595";"2. Neyman known";"2. Neyman known";433;438;98;340;448;552
"2596";"3. RSIHR Known";"3. RSIHR Known";433;486;70;416;357;643
"2597";"4. Rosenberger known";"4. Rosenberger known";433;567;30;537;147;853
"2598";"5. Optimal adjusted";"5. Optimal adjusted";433;413;104;309;529;471
"2599";"1. Random";"1. Random";434;423;99;324;488;512
"2600";"6. Biased  coin";"6. Biased  coin";434;389;86;303;501;500
"2601";"2. Neyman known";"2. Neyman known";434;425;94;331;446;554
"2602";"3. RSIHR Known";"3. RSIHR Known";434;426;64;362;400;600
"2603";"4. Rosenberger known";"4. Rosenberger known";434;551;31;520;150;850
"2604";"5. Optimal adjusted";"5. Optimal adjusted";434;392;115;277;544;456
"2605";"1. Random";"1. Random";435;406;102;304;484;516
"2606";"6. Biased  coin";"6. Biased  coin";435;377;94;283;500;500
"2607";"2. Neyman known";"2. Neyman known";435;412;80;332;436;564
"2608";"3. RSIHR Known";"3. RSIHR Known";435;446;78;368;383;617
"2609";"4. Rosenberger known";"4. Rosenberger known";435;558;36;522;150;850
"2610";"5. Optimal adjusted";"5. Optimal adjusted";435;363;95;268;551;449
"2611";"1. Random";"1. Random";436;397;100;297;504;496
"2612";"6. Biased  coin";"6. Biased  coin";436;398;98;300;499;501
"2613";"2. Neyman known";"2. Neyman known";436;415;82;333;443;557
"2614";"3. RSIHR Known";"3. RSIHR Known";436;483;81;402;364;636
"2615";"4. Rosenberger known";"4. Rosenberger known";436;543;20;523;148;852
"2616";"5. Optimal adjusted";"5. Optimal adjusted";436;388;108;280;531;469
"2617";"1. Random";"1. Random";437;400;86;314;504;496
"2618";"6. Biased  coin";"6. Biased  coin";437;390;91;299;499;501
"2619";"2. Neyman known";"2. Neyman known";437;412;91;321;462;538
"2620";"3. RSIHR Known";"3. RSIHR Known";437;439;75;364;385;615
"2621";"4. Rosenberger known";"4. Rosenberger known";437;522;20;502;148;852
"2622";"5. Optimal adjusted";"5. Optimal adjusted";437;379;90;289;525;475
"2623";"1. Random";"1. Random";438;373;95;278;504;496
"2624";"6. Biased  coin";"6. Biased  coin";438;388;94;294;499;501
"2625";"2. Neyman known";"2. Neyman known";438;400;80;320;438;562
"2626";"3. RSIHR Known";"3. RSIHR Known";438;449;79;370;379;621
"2627";"4. Rosenberger known";"4. Rosenberger known";438;529;30;499;154;846
"2628";"5. Optimal adjusted";"5. Optimal adjusted";438;402;109;293;510;490
"2629";"1. Random";"1. Random";439;390;92;298;516;484
"2630";"6. Biased  coin";"6. Biased  coin";439;405;94;311;500;500
"2631";"2. Neyman known";"2. Neyman known";439;414;91;323;465;535
"2632";"3. RSIHR Known";"3. RSIHR Known";439;428;72;356;399;601
"2633";"4. Rosenberger known";"4. Rosenberger known";439;535;26;509;145;855
"2634";"5. Optimal adjusted";"5. Optimal adjusted";439;373;99;274;535;465
"2635";"1. Random";"1. Random";440;398;98;300;514;486
"2636";"6. Biased  coin";"6. Biased  coin";440;417;108;309;502;499
"2637";"2. Neyman known";"2. Neyman known";440;429;108;321;483;517
"2638";"3. RSIHR Known";"3. RSIHR Known";440;456;68;388;351;649
"2639";"4. Rosenberger known";"4. Rosenberger known";440;541;24;517;146;854
"2640";"5. Optimal adjusted";"5. Optimal adjusted";440;402;119;283;532;468
"2641";"1. Random";"1. Random";441;397;104;293;500;500
"2642";"6. Biased  coin";"6. Biased  coin";441;410;107;303;500;500
"2643";"2. Neyman known";"2. Neyman known";441;441;102;339;455;545
"2644";"3. RSIHR Known";"3. RSIHR Known";441;469;74;395;355;645
"2645";"4. Rosenberger known";"4. Rosenberger known";441;550;19;531;125;875
"2646";"5. Optimal adjusted";"5. Optimal adjusted";441;385;108;277;536;464
"2647";"1. Random";"1. Random";442;411;102;309;491;509
"2648";"6. Biased  coin";"6. Biased  coin";442;401;87;314;501;500
"2649";"2. Neyman known";"2. Neyman known";442;447;86;361;442;558
"2650";"3. RSIHR Known";"3. RSIHR Known";442;490;86;404;372;628
"2651";"4. Rosenberger known";"4. Rosenberger known";442;564;30;534;144;856
"2652";"5. Optimal adjusted";"5. Optimal adjusted";442;388;110;278;559;441
"2653";"1. Random";"1. Random";443;401;98;303;523;477
"2654";"6. Biased  coin";"6. Biased  coin";443;423;112;311;500;500
"2655";"2. Neyman known";"2. Neyman known";443;437;106;331;479;521
"2656";"3. RSIHR Known";"3. RSIHR Known";443;464;75;389;380;620
"2657";"4. Rosenberger known";"4. Rosenberger known";443;563;32;531;143;857
"2658";"5. Optimal adjusted";"5. Optimal adjusted";443;412;115;297;521;479
"2659";"1. Random";"1. Random";444;411;107;304;496;504
"2660";"6. Biased  coin";"6. Biased  coin";444;418;105;313;499;501
"2661";"2. Neyman known";"2. Neyman known";444;403;96;307;447;553
"2662";"3. RSIHR Known";"3. RSIHR Known";444;462;78;384;350;650
"2663";"4. Rosenberger known";"4. Rosenberger known";444;537;19;518;130;870
"2664";"5. Optimal adjusted";"5. Optimal adjusted";444;364;114;250;543;457
"2665";"1. Random";"1. Random";445;391;112;279;534;466
"2666";"6. Biased  coin";"6. Biased  coin";445;381;99;282;499;501
"2667";"2. Neyman known";"2. Neyman known";445;434;104;330;458;542
"2668";"3. RSIHR Known";"3. RSIHR Known";445;463;82;381;376;624
"2669";"4. Rosenberger known";"4. Rosenberger known";445;530;25;505;155;845
"2670";"5. Optimal adjusted";"5. Optimal adjusted";445;400;110;290;528;472
"2671";"1. Random";"1. Random";446;385;98;287;507;493
"2672";"6. Biased  coin";"6. Biased  coin";446;379;90;289;502;500
"2673";"2. Neyman known";"2. Neyman known";446;418;93;325;427;573
"2674";"3. RSIHR Known";"3. RSIHR Known";446;451;85;366;392;608
"2675";"4. Rosenberger known";"4. Rosenberger known";446;539;28;511;136;864
"2676";"5. Optimal adjusted";"5. Optimal adjusted";446;374;108;266;546;454
"2677";"1. Random";"1. Random";447;418;102;316;499;501
"2678";"6. Biased  coin";"6. Biased  coin";447;426;99;327;501;499
"2679";"2. Neyman known";"2. Neyman known";447;446;96;350;439;561
"2680";"3. RSIHR Known";"3. RSIHR Known";447;460;81;379;364;636
"2681";"4. Rosenberger known";"4. Rosenberger known";447;539;23;516;154;846
"2682";"5. Optimal adjusted";"5. Optimal adjusted";447;392;110;282;546;454
"2683";"1. Random";"1. Random";448;408;100;308;482;518
"2684";"6. Biased  coin";"6. Biased  coin";448;394;96;298;501;499
"2685";"2. Neyman known";"2. Neyman known";448;404;84;320;459;541
"2686";"3. RSIHR Known";"3. RSIHR Known";448;441;67;374;368;632
"2687";"4. Rosenberger known";"4. Rosenberger known";448;533;30;503;149;851
"2688";"5. Optimal adjusted";"5. Optimal adjusted";448;394;118;276;549;451
"2689";"1. Random";"1. Random";449;405;105;300;502;498
"2690";"6. Biased  coin";"6. Biased  coin";449;401;101;300;500;500
"2691";"2. Neyman known";"2. Neyman known";449;413;92;321;464;536
"2692";"3. RSIHR Known";"3. RSIHR Known";449;436;53;383;352;648
"2693";"4. Rosenberger known";"4. Rosenberger known";449;553;34;519;158;842
"2694";"5. Optimal adjusted";"5. Optimal adjusted";449;404;94;310;500;500
"2695";"1. Random";"1. Random";450;409;95;314;501;499
"2696";"6. Biased  coin";"6. Biased  coin";450;399;101;298;500;500
"2697";"2. Neyman known";"2. Neyman known";450;442;100;342;447;553
"2698";"3. RSIHR Known";"3. RSIHR Known";450;454;70;384;373;627
"2699";"4. Rosenberger known";"4. Rosenberger known";450;545;27;518;138;862
"2700";"5. Optimal adjusted";"5. Optimal adjusted";450;395;106;289;545;455
"2701";"1. Random";"1. Random";451;409;98;311;497;503
"2702";"6. Biased  coin";"6. Biased  coin";451;411;101;310;500;500
"2703";"2. Neyman known";"2. Neyman known";451;431;86;345;432;568
"2704";"3. RSIHR Known";"3. RSIHR Known";451;458;73;385;373;627
"2705";"4. Rosenberger known";"4. Rosenberger known";451;542;25;517;134;866
"2706";"5. Optimal adjusted";"5. Optimal adjusted";451;371;108;263;558;442
"2707";"1. Random";"1. Random";452;402;90;312;494;506
"2708";"6. Biased  coin";"6. Biased  coin";452;415;103;312;501;499
"2709";"2. Neyman known";"2. Neyman known";452;409;77;332;444;556
"2710";"3. RSIHR Known";"3. RSIHR Known";452;445;63;382;383;617
"2711";"4. Rosenberger known";"4. Rosenberger known";452;548;23;525;141;859
"2712";"5. Optimal adjusted";"5. Optimal adjusted";452;384;107;277;546;454
"2713";"1. Random";"1. Random";453;400;95;305;488;512
"2714";"6. Biased  coin";"6. Biased  coin";453;401;91;310;500;500
"2715";"2. Neyman known";"2. Neyman known";453;431;91;340;452;548
"2716";"3. RSIHR Known";"3. RSIHR Known";453;466;76;390;366;634
"2717";"4. Rosenberger known";"4. Rosenberger known";453;564;24;540;139;861
"2718";"5. Optimal adjusted";"5. Optimal adjusted";453;381;96;285;511;489
"2719";"1. Random";"1. Random";454;416;115;301;504;496
"2720";"6. Biased  coin";"6. Biased  coin";454;400;100;300;500;500
"2721";"2. Neyman known";"2. Neyman known";454;423;101;322;454;546
"2722";"3. RSIHR Known";"3. RSIHR Known";454;442;76;366;370;630
"2723";"4. Rosenberger known";"4. Rosenberger known";454;531;28;503;142;858
"2724";"5. Optimal adjusted";"5. Optimal adjusted";454;372;104;268;542;458
"2725";"1. Random";"1. Random";455;390;88;302;500;500
"2726";"6. Biased  coin";"6. Biased  coin";455;390;85;305;500;502
"2727";"2. Neyman known";"2. Neyman known";455;415;78;337;445;555
"2728";"3. RSIHR Known";"3. RSIHR Known";455;458;62;396;345;655
"2729";"4. Rosenberger known";"4. Rosenberger known";455;535;22;513;139;861
"2730";"5. Optimal adjusted";"5. Optimal adjusted";455;375;96;279;534;466
"2731";"1. Random";"1. Random";456;388;80;308;480;520
"2732";"6. Biased  coin";"6. Biased  coin";456;395;101;294;501;500
"2733";"2. Neyman known";"2. Neyman known";456;403;83;320;459;541
"2734";"3. RSIHR Known";"3. RSIHR Known";456;449;69;380;385;615
"2735";"4. Rosenberger known";"4. Rosenberger known";456;542;23;519;136;864
"2736";"5. Optimal adjusted";"5. Optimal adjusted";456;378;100;278;544;456
"2737";"1. Random";"1. Random";457;398;90;308;489;511
"2738";"6. Biased  coin";"6. Biased  coin";457;406;91;315;502;500
"2739";"2. Neyman known";"2. Neyman known";457;405;80;325;461;539
"2740";"3. RSIHR Known";"3. RSIHR Known";457;443;72;371;391;609
"2741";"4. Rosenberger known";"4. Rosenberger known";457;546;18;528;128;872
"2742";"5. Optimal adjusted";"5. Optimal adjusted";457;390;99;291;534;466
"2743";"1. Random";"1. Random";458;363;82;281;508;492
"2744";"6. Biased  coin";"6. Biased  coin";458;406;97;309;501;500
"2745";"2. Neyman known";"2. Neyman known";458;402;78;324;449;551
"2746";"3. RSIHR Known";"3. RSIHR Known";458;448;56;392;345;655
"2747";"4. Rosenberger known";"4. Rosenberger known";458;527;18;509;142;858
"2748";"5. Optimal adjusted";"5. Optimal adjusted";458;366;99;267;548;452
"2749";"1. Random";"1. Random";459;417;104;313;506;494
"2750";"6. Biased  coin";"6. Biased  coin";459;409;91;318;498;502
"2751";"2. Neyman known";"2. Neyman known";459;439;84;355;435;565
"2752";"3. RSIHR Known";"3. RSIHR Known";459;487;95;392;410;590
"2753";"4. Rosenberger known";"4. Rosenberger known";459;591;31;560;140;860
"2754";"5. Optimal adjusted";"5. Optimal adjusted";459;398;104;294;538;462
"2755";"1. Random";"1. Random";460;415;98;317;473;527
"2756";"6. Biased  coin";"6. Biased  coin";460;401;103;298;500;500
"2757";"2. Neyman known";"2. Neyman known";460;424;107;317;461;539
"2758";"3. RSIHR Known";"3. RSIHR Known";460;452;79;373;379;621
"2759";"4. Rosenberger known";"4. Rosenberger known";460;553;31;522;143;857
"2760";"5. Optimal adjusted";"5. Optimal adjusted";460;395;112;283;548;452
"2761";"1. Random";"1. Random";461;392;103;289;525;475
"2762";"6. Biased  coin";"6. Biased  coin";461;405;100;305;500;500
"2763";"2. Neyman known";"2. Neyman known";461;431;97;334;459;541
"2764";"3. RSIHR Known";"3. RSIHR Known";461;484;61;423;347;653
"2765";"4. Rosenberger known";"4. Rosenberger known";461;557;26;531;140;860
"2766";"5. Optimal adjusted";"5. Optimal adjusted";461;381;96;285;540;460
"2767";"1. Random";"1. Random";462;394;103;291;518;482
"2768";"6. Biased  coin";"6. Biased  coin";462;395;98;297;500;501
"2769";"2. Neyman known";"2. Neyman known";462;418;81;337;428;572
"2770";"3. RSIHR Known";"3. RSIHR Known";462;459;83;376;360;640
"2771";"4. Rosenberger known";"4. Rosenberger known";462;537;39;498;155;845
"2772";"5. Optimal adjusted";"5. Optimal adjusted";462;398;105;293;511;489
"2773";"1. Random";"1. Random";463;392;95;297;505;495
"2774";"6. Biased  coin";"6. Biased  coin";463;382;92;290;502;499
"2775";"2. Neyman known";"2. Neyman known";463;393;71;322;453;547
"2776";"3. RSIHR Known";"3. RSIHR Known";463;442;62;380;346;654
"2777";"4. Rosenberger known";"4. Rosenberger known";463;540;22;518;134;866
"2778";"5. Optimal adjusted";"5. Optimal adjusted";463;388;106;282;550;450
"2779";"1. Random";"1. Random";464;416;106;310;504;496
"2780";"6. Biased  coin";"6. Biased  coin";464;407;104;303;498;503
"2781";"2. Neyman known";"2. Neyman known";464;431;100;331;462;538
"2782";"3. RSIHR Known";"3. RSIHR Known";464;462;76;386;365;635
"2783";"4. Rosenberger known";"4. Rosenberger known";464;563;34;529;155;845
"2784";"5. Optimal adjusted";"5. Optimal adjusted";464;411;118;293;517;483
"2785";"1. Random";"1. Random";465;419;102;317;483;517
"2786";"6. Biased  coin";"6. Biased  coin";465;398;98;300;502;500
"2787";"2. Neyman known";"2. Neyman known";465;405;82;323;456;544
"2788";"3. RSIHR Known";"3. RSIHR Known";465;455;79;376;378;622
"2789";"4. Rosenberger known";"4. Rosenberger known";465;538;27;511;150;850
"2790";"5. Optimal adjusted";"5. Optimal adjusted";465;392;100;292;539;461
"2791";"1. Random";"1. Random";466;409;105;304;489;511
"2792";"6. Biased  coin";"6. Biased  coin";466;397;106;291;501;500
"2793";"2. Neyman known";"2. Neyman known";466;435;93;342;444;556
"2794";"3. RSIHR Known";"3. RSIHR Known";466;472;81;391;350;650
"2795";"4. Rosenberger known";"4. Rosenberger known";466;551;37;514;142;858
"2796";"5. Optimal adjusted";"5. Optimal adjusted";466;407;127;280;537;463
"2797";"1. Random";"1. Random";467;392;108;284;538;462
"2798";"6. Biased  coin";"6. Biased  coin";467;429;102;327;500;500
"2799";"2. Neyman known";"2. Neyman known";467;445;80;365;437;563
"2800";"3. RSIHR Known";"3. RSIHR Known";467;476;86;390;382;618
"2801";"4. Rosenberger known";"4. Rosenberger known";467;572;30;542;137;863
"2802";"5. Optimal adjusted";"5. Optimal adjusted";467;404;110;294;542;458
"2803";"1. Random";"1. Random";468;372;98;274;536;464
"2804";"6. Biased  coin";"6. Biased  coin";468;405;106;299;500;500
"2805";"2. Neyman known";"2. Neyman known";468;402;78;324;456;544
"2806";"3. RSIHR Known";"3. RSIHR Known";468;444;67;377;386;614
"2807";"4. Rosenberger known";"4. Rosenberger known";468;532;26;506;154;846
"2808";"5. Optimal adjusted";"5. Optimal adjusted";468;400;109;291;528;472
"2809";"1. Random";"1. Random";469;401;93;308;509;491
"2810";"6. Biased  coin";"6. Biased  coin";469;406;97;309;499;501
"2811";"2. Neyman known";"2. Neyman known";469;423;83;340;457;543
"2812";"3. RSIHR Known";"3. RSIHR Known";469;464;70;394;355;645
"2813";"4. Rosenberger known";"4. Rosenberger known";469;563;28;535;136;864
"2814";"5. Optimal adjusted";"5. Optimal adjusted";469;387;98;289;535;465
"2815";"1. Random";"1. Random";470;400;104;296;502;498
"2816";"6. Biased  coin";"6. Biased  coin";470;388;103;285;501;499
"2817";"2. Neyman known";"2. Neyman known";470;434;88;346;412;588
"2818";"3. RSIHR Known";"3. RSIHR Known";470;452;79;373;373;627
"2819";"4. Rosenberger known";"4. Rosenberger known";470;542;36;506;140;860
"2820";"5. Optimal adjusted";"5. Optimal adjusted";470;387;108;279;513;487
"2821";"1. Random";"1. Random";471;393;94;299;512;488
"2822";"6. Biased  coin";"6. Biased  coin";471;376;85;291;501;499
"2823";"2. Neyman known";"2. Neyman known";471;417;84;333;439;561
"2824";"3. RSIHR Known";"3. RSIHR Known";471;461;71;390;351;649
"2825";"4. Rosenberger known";"4. Rosenberger known";471;534;34;500;163;837
"2826";"5. Optimal adjusted";"5. Optimal adjusted";471;375;103;272;534;466
"2827";"1. Random";"1. Random";472;390;96;294;520;480
"2828";"6. Biased  coin";"6. Biased  coin";472;401;93;308;500;500
"2829";"2. Neyman known";"2. Neyman known";472;442;90;352;441;559
"2830";"3. RSIHR Known";"3. RSIHR Known";472;469;66;403;341;659
"2831";"4. Rosenberger known";"4. Rosenberger known";472;560;27;533;135;865
"2832";"5. Optimal adjusted";"5. Optimal adjusted";472;372;102;270;540;460
"2833";"1. Random";"1. Random";473;401;109;292;509;491
"2834";"6. Biased  coin";"6. Biased  coin";473;407;111;296;501;500
"2835";"2. Neyman known";"2. Neyman known";473;412;97;315;457;543
"2836";"3. RSIHR Known";"3. RSIHR Known";473;466;79;387;364;636
"2837";"4. Rosenberger known";"4. Rosenberger known";473;544;26;518;135;865
"2838";"5. Optimal adjusted";"5. Optimal adjusted";473;377;109;268;530;470
"2839";"1. Random";"1. Random";474;372;101;271;524;476
"2840";"6. Biased  coin";"6. Biased  coin";474;394;109;285;501;500
"2841";"2. Neyman known";"2. Neyman known";474;411;85;326;447;553
"2842";"3. RSIHR Known";"3. RSIHR Known";474;451;65;386;342;658
"2843";"4. Rosenberger known";"4. Rosenberger known";474;522;28;494;163;837
"2844";"5. Optimal adjusted";"5. Optimal adjusted";474;392;105;287;521;479
"2845";"1. Random";"1. Random";475;384;96;288;512;488
"2846";"6. Biased  coin";"6. Biased  coin";475;384;87;297;500;500
"2847";"2. Neyman known";"2. Neyman known";475;408;78;330;447;553
"2848";"3. RSIHR Known";"3. RSIHR Known";475;433;64;369;386;614
"2849";"4. Rosenberger known";"4. Rosenberger known";475;530;21;509;129;871
"2850";"5. Optimal adjusted";"5. Optimal adjusted";475;375;93;282;533;467
"2851";"1. Random";"1. Random";476;400;99;301;499;501
"2852";"6. Biased  coin";"6. Biased  coin";476;390;99;291;502;498
"2853";"2. Neyman known";"2. Neyman known";476;410;84;326;445;555
"2854";"3. RSIHR Known";"3. RSIHR Known";476;450;79;371;387;613
"2855";"4. Rosenberger known";"4. Rosenberger known";476;540;26;514;143;857
"2856";"5. Optimal adjusted";"5. Optimal adjusted";476;373;98;275;539;461
"2857";"1. Random";"1. Random";477;402;95;307;501;499
"2858";"6. Biased  coin";"6. Biased  coin";477;389;86;303;500;500
"2859";"2. Neyman known";"2. Neyman known";477;403;66;337;440;560
"2860";"3. RSIHR Known";"3. RSIHR Known";477;450;74;376;377;623
"2861";"4. Rosenberger known";"4. Rosenberger known";477;530;28;502;153;847
"2862";"5. Optimal adjusted";"5. Optimal adjusted";477;357;97;260;567;433
"2863";"1. Random";"1. Random";478;394;103;291;498;502
"2864";"6. Biased  coin";"6. Biased  coin";478;390;100;290;499;501
"2865";"2. Neyman known";"2. Neyman known";478;422;89;333;442;558
"2866";"3. RSIHR Known";"3. RSIHR Known";478;460;80;380;366;634
"2867";"4. Rosenberger known";"4. Rosenberger known";478;542;35;507;147;853
"2868";"5. Optimal adjusted";"5. Optimal adjusted";478;371;109;262;553;447
"2869";"1. Random";"1. Random";479;373;85;288;494;506
"2870";"6. Biased  coin";"6. Biased  coin";479;394;88;306;501;500
"2871";"2. Neyman known";"2. Neyman known";479;396;78;318;462;538
"2872";"3. RSIHR Known";"3. RSIHR Known";479;469;68;401;336;664
"2873";"4. Rosenberger known";"4. Rosenberger known";479;531;28;503;148;852
"2874";"5. Optimal adjusted";"5. Optimal adjusted";479;378;98;280;532;468
"2875";"1. Random";"1. Random";480;413;103;310;481;519
"2876";"6. Biased  coin";"6. Biased  coin";480;387;102;285;502;500
"2877";"2. Neyman known";"2. Neyman known";480;411;106;305;460;540
"2878";"3. RSIHR Known";"3. RSIHR Known";480;452;84;368;380;620
"2879";"4. Rosenberger known";"4. Rosenberger known";480;539;37;502;161;839
"2880";"5. Optimal adjusted";"5. Optimal adjusted";480;365;106;259;553;447
"2881";"1. Random";"1. Random";481;404;113;291;501;499
"2882";"6. Biased  coin";"6. Biased  coin";481;394;104;290;500;500
"2883";"2. Neyman known";"2. Neyman known";481;416;101;315;493;507
"2884";"3. RSIHR Known";"3. RSIHR Known";481;467;73;394;379;621
"2885";"4. Rosenberger known";"4. Rosenberger known";481;555;43;512;164;836
"2886";"5. Optimal adjusted";"5. Optimal adjusted";481;409;113;296;510;490
"2887";"1. Random";"1. Random";482;382;87;295;473;527
"2888";"6. Biased  coin";"6. Biased  coin";482;400;110;290;501;500
"2889";"2. Neyman known";"2. Neyman known";482;378;92;286;470;530
"2890";"3. RSIHR Known";"3. RSIHR Known";482;439;75;364;374;626
"2891";"4. Rosenberger known";"4. Rosenberger known";482;512;21;491;137;863
"2892";"5. Optimal adjusted";"5. Optimal adjusted";482;345;90;255;525;475
"2893";"1. Random";"1. Random";483;390;114;276;503;497
"2894";"6. Biased  coin";"6. Biased  coin";483;413;121;292;501;500
"2895";"2. Neyman known";"2. Neyman known";483;422;94;328;436;564
"2896";"3. RSIHR Known";"3. RSIHR Known";483;461;89;372;362;638
"2897";"4. Rosenberger known";"4. Rosenberger known";483;533;27;506;124;876
"2898";"5. Optimal adjusted";"5. Optimal adjusted";483;407;134;273;540;460
"2899";"1. Random";"1. Random";484;379;92;287;507;493
"2900";"6. Biased  coin";"6. Biased  coin";484;403;98;305;499;501
"2901";"2. Neyman known";"2. Neyman known";484;403;68;335;417;583
"2902";"3. RSIHR Known";"3. RSIHR Known";484;440;67;373;385;615
"2903";"4. Rosenberger known";"4. Rosenberger known";484;540;28;512;140;860
"2904";"5. Optimal adjusted";"5. Optimal adjusted";484;395;108;287;517;483
"2905";"1. Random";"1. Random";485;392;89;303;500;500
"2906";"6. Biased  coin";"6. Biased  coin";485;394;86;308;503;500
"2907";"2. Neyman known";"2. Neyman known";485;430;82;348;439;561
"2908";"3. RSIHR Known";"3. RSIHR Known";485;443;62;381;355;645
"2909";"4. Rosenberger known";"4. Rosenberger known";485;553;28;525;144;856
"2910";"5. Optimal adjusted";"5. Optimal adjusted";485;382;94;288;534;466
"2911";"1. Random";"1. Random";486;383;84;299;482;518
"2912";"6. Biased  coin";"6. Biased  coin";486;401;100;301;503;498
"2913";"2. Neyman known";"2. Neyman known";486;430;95;335;447;553
"2914";"3. RSIHR Known";"3. RSIHR Known";486;470;73;397;363;637
"2915";"4. Rosenberger known";"4. Rosenberger known";486;536;23;513;152;848
"2916";"5. Optimal adjusted";"5. Optimal adjusted";486;389;96;293;522;478
"2917";"1. Random";"1. Random";487;388;92;296;502;498
"2918";"6. Biased  coin";"6. Biased  coin";487;387;93;294;500;500
"2919";"2. Neyman known";"2. Neyman known";487;417;76;341;443;557
"2920";"3. RSIHR Known";"3. RSIHR Known";487;444;61;383;363;637
"2921";"4. Rosenberger known";"4. Rosenberger known";487;545;31;514;138;862
"2922";"5. Optimal adjusted";"5. Optimal adjusted";487;379;82;297;514;486
"2923";"1. Random";"1. Random";488;393;93;300;508;492
"2924";"6. Biased  coin";"6. Biased  coin";488;401;100;301;500;500
"2925";"2. Neyman known";"2. Neyman known";488;410;77;333;426;574
"2926";"3. RSIHR Known";"3. RSIHR Known";488;451;83;368;404;596
"2927";"4. Rosenberger known";"4. Rosenberger known";488;552;32;520;150;850
"2928";"5. Optimal adjusted";"5. Optimal adjusted";488;388;105;283;529;471
"2929";"1. Random";"1. Random";489;398;102;296;504;496
"2930";"6. Biased  coin";"6. Biased  coin";489;415;102;313;501;500
"2931";"2. Neyman known";"2. Neyman known";489;416;86;330;448;552
"2932";"3. RSIHR Known";"3. RSIHR Known";489;463;65;398;346;654
"2933";"4. Rosenberger known";"4. Rosenberger known";489;539;19;520;132;868
"2934";"5. Optimal adjusted";"5. Optimal adjusted";489;368;117;251;552;448
"2935";"1. Random";"1. Random";490;401;84;317;504;496
"2936";"6. Biased  coin";"6. Biased  coin";490;399;88;311;501;499
"2937";"2. Neyman known";"2. Neyman known";490;426;82;344;448;552
"2938";"3. RSIHR Known";"3. RSIHR Known";490;483;57;426;330;670
"2939";"4. Rosenberger known";"4. Rosenberger known";490;563;24;539;125;875
"2940";"5. Optimal adjusted";"5. Optimal adjusted";490;398;99;299;510;490
"2941";"1. Random";"1. Random";491;396;102;294;490;510
"2942";"6. Biased  coin";"6. Biased  coin";491;391;99;292;501;499
"2943";"2. Neyman known";"2. Neyman known";491;420;96;324;436;564
"2944";"3. RSIHR Known";"3. RSIHR Known";491;415;77;338;389;611
"2945";"4. Rosenberger known";"4. Rosenberger known";491;527;33;494;144;856
"2946";"5. Optimal adjusted";"5. Optimal adjusted";491;381;122;259;548;452
"2947";"1. Random";"1. Random";492;397;106;291;532;468
"2948";"6. Biased  coin";"6. Biased  coin";492;426;111;315;501;500
"2949";"2. Neyman known";"2. Neyman known";492;439;97;342;458;542
"2950";"3. RSIHR Known";"3. RSIHR Known";492;453;73;380;364;636
"2951";"4. Rosenberger known";"4. Rosenberger known";492;564;34;530;148;852
"2952";"5. Optimal adjusted";"5. Optimal adjusted";492;375;102;273;549;451
"2953";"1. Random";"1. Random";493;394;98;296;503;497
"2954";"6. Biased  coin";"6. Biased  coin";493;402;102;300;502;499
"2955";"2. Neyman known";"2. Neyman known";493;418;79;339;436;564
"2956";"3. RSIHR Known";"3. RSIHR Known";493;449;73;376;365;635
"2957";"4. Rosenberger known";"4. Rosenberger known";493;553;38;515;143;857
"2958";"5. Optimal adjusted";"5. Optimal adjusted";493;401;117;284;529;471
"2959";"1. Random";"1. Random";494;407;112;295;508;492
"2960";"6. Biased  coin";"6. Biased  coin";494;399;98;301;499;501
"2961";"2. Neyman known";"2. Neyman known";494;422;85;337;434;566
"2962";"3. RSIHR Known";"3. RSIHR Known";494;441;77;364;377;623
"2963";"4. Rosenberger known";"4. Rosenberger known";494;545;27;518;141;859
"2964";"5. Optimal adjusted";"5. Optimal adjusted";494;355;108;247;570;430
"2965";"1. Random";"1. Random";495;396;91;305;492;508
"2966";"6. Biased  coin";"6. Biased  coin";495;402;92;310;501;499
"2967";"2. Neyman known";"2. Neyman known";495;408;76;332;441;559
"2968";"3. RSIHR Known";"3. RSIHR Known";495;466;61;405;339;661
"2969";"4. Rosenberger known";"4. Rosenberger known";495;553;27;526;123;877
"2970";"5. Optimal adjusted";"5. Optimal adjusted";495;367;81;286;518;482
"2971";"1. Random";"1. Random";496;408;112;296;533;467
"2972";"6. Biased  coin";"6. Biased  coin";496;396;83;313;499;501
"2973";"2. Neyman known";"2. Neyman known";496;436;87;349;447;553
"2974";"3. RSIHR Known";"3. RSIHR Known";496;474;67;407;351;649
"2975";"4. Rosenberger known";"4. Rosenberger known";496;551;30;521;154;846
"2976";"5. Optimal adjusted";"5. Optimal adjusted";496;387;103;284;537;463
"2977";"1. Random";"1. Random";497;387;100;287;515;485
"2978";"6. Biased  coin";"6. Biased  coin";497;401;90;311;503;497
"2979";"2. Neyman known";"2. Neyman known";497;421;79;342;442;558
"2980";"3. RSIHR Known";"3. RSIHR Known";497;463;72;391;363;637
"2981";"4. Rosenberger known";"4. Rosenberger known";497;539;28;511;152;848
"2982";"5. Optimal adjusted";"5. Optimal adjusted";497;370;106;264;560;440
"2983";"1. Random";"1. Random";498;385;88;297;509;491
"2984";"6. Biased  coin";"6. Biased  coin";498;374;95;279;500;500
"2985";"2. Neyman known";"2. Neyman known";498;421;93;328;442;558
"2986";"3. RSIHR Known";"3. RSIHR Known";498;451;80;371;369;631
"2987";"4. Rosenberger known";"4. Rosenberger known";498;545;27;518;134;866
"2988";"5. Optimal adjusted";"5. Optimal adjusted";498;380;105;275;504;496
"2989";"1. Random";"1. Random";499;392;88;304;501;499
"2990";"6. Biased  coin";"6. Biased  coin";499;416;99;317;503;498
"2991";"2. Neyman known";"2. Neyman known";499;436;85;351;421;579
"2992";"3. RSIHR Known";"3. RSIHR Known";499;483;69;414;341;659
"2993";"4. Rosenberger known";"4. Rosenberger known";499;562;28;534;144;856
"2994";"5. Optimal adjusted";"5. Optimal adjusted";499;398;92;306;523;477
"2995";"1. Random";"1. Random";500;415;96;319;483;517
"2996";"6. Biased  coin";"6. Biased  coin";500;419;97;322;499;501
"2997";"2. Neyman known";"2. Neyman known";500;424;81;343;437;563
"2998";"3. RSIHR Known";"3. RSIHR Known";500;465;75;390;367;633
"2999";"4. Rosenberger known";"4. Rosenberger known";500;570;24;546;136;864
"3000";"5. Optimal adjusted";"5. Optimal adjusted";500;395;99;296;539;461
"3001";"1. Random";"1. Random";501;404;101;303;493;507
"3002";"6. Biased  coin";"6. Biased  coin";501;416;111;305;502;499
"3003";"2. Neyman known";"2. Neyman known";501;439;89;350;448;552
"3004";"3. RSIHR Known";"3. RSIHR Known";501;472;99;373;401;599
"3005";"4. Rosenberger known";"4. Rosenberger known";501;546;27;519;141;859
"3006";"5. Optimal adjusted";"5. Optimal adjusted";501;393;116;277;537;463
"3007";"1. Random";"1. Random";502;416;104;312;472;528
"3008";"6. Biased  coin";"6. Biased  coin";502;395;103;292;501;501
"3009";"2. Neyman known";"2. Neyman known";502;393;98;295;477;523
"3010";"3. RSIHR Known";"3. RSIHR Known";502;452;78;374;355;645
"3011";"4. Rosenberger known";"4. Rosenberger known";502;534;33;501;138;862
"3012";"5. Optimal adjusted";"5. Optimal adjusted";502;401;116;285;526;474
"3013";"1. Random";"1. Random";503;382;91;291;492;508
"3014";"6. Biased  coin";"6. Biased  coin";503;402;108;294;500;501
"3015";"2. Neyman known";"2. Neyman known";503;421;95;326;465;535
"3016";"3. RSIHR Known";"3. RSIHR Known";503;441;77;364;387;613
"3017";"4. Rosenberger known";"4. Rosenberger known";503;546;28;518;128;872
"3018";"5. Optimal adjusted";"5. Optimal adjusted";503;376;114;262;547;453
"3019";"1. Random";"1. Random";504;410;95;315;492;508
"3020";"6. Biased  coin";"6. Biased  coin";504;416;105;311;500;500
"3021";"2. Neyman known";"2. Neyman known";504;411;80;331;446;554
"3022";"3. RSIHR Known";"3. RSIHR Known";504;461;61;400;358;642
"3023";"4. Rosenberger known";"4. Rosenberger known";504;551;26;525;142;858
"3024";"5. Optimal adjusted";"5. Optimal adjusted";504;378;95;283;541;459
"3025";"1. Random";"1. Random";505;408;111;297;530;470
"3026";"6. Biased  coin";"6. Biased  coin";505;402;105;297;498;502
"3027";"2. Neyman known";"2. Neyman known";505;419;93;326;462;538
"3028";"3. RSIHR Known";"3. RSIHR Known";505;468;72;396;349;651
"3029";"4. Rosenberger known";"4. Rosenberger known";505;538;26;512;132;868
"3030";"5. Optimal adjusted";"5. Optimal adjusted";505;383;114;269;544;456
"3031";"1. Random";"1. Random";506;406;109;297;504;496
"3032";"6. Biased  coin";"6. Biased  coin";506;420;116;304;502;499
"3033";"2. Neyman known";"2. Neyman known";506;442;106;336;456;544
"3034";"3. RSIHR Known";"3. RSIHR Known";506;469;85;384;356;644
"3035";"4. Rosenberger known";"4. Rosenberger known";506;549;30;519;131;869
"3036";"5. Optimal adjusted";"5. Optimal adjusted";506;394;113;281;546;454
"3037";"1. Random";"1. Random";507;413;93;320;526;474
"3038";"6. Biased  coin";"6. Biased  coin";507;415;102;313;500;500
"3039";"2. Neyman known";"2. Neyman known";507;458;72;386;413;587
"3040";"3. RSIHR Known";"3. RSIHR Known";507;465;65;400;368;632
"3041";"4. Rosenberger known";"4. Rosenberger known";507;564;17;547;135;865
"3042";"5. Optimal adjusted";"5. Optimal adjusted";507;391;100;291;528;472
"3043";"1. Random";"1. Random";508;391;115;276;537;463
"3044";"6. Biased  coin";"6. Biased  coin";508;386;83;303;500;500
"3045";"2. Neyman known";"2. Neyman known";508;429;96;333;455;545
"3046";"3. RSIHR Known";"3. RSIHR Known";508;433;80;353;377;623
"3047";"4. Rosenberger known";"4. Rosenberger known";508;556;27;529;130;870
"3048";"5. Optimal adjusted";"5. Optimal adjusted";508;373;106;267;547;453
"3049";"1. Random";"1. Random";509;410;95;315;479;521
"3050";"6. Biased  coin";"6. Biased  coin";509;407;106;301;503;499
"3051";"2. Neyman known";"2. Neyman known";509;429;96;333;433;567
"3052";"3. RSIHR Known";"3. RSIHR Known";509;477;95;382;375;625
"3053";"4. Rosenberger known";"4. Rosenberger known";509;553;26;527;136;864
"3054";"5. Optimal adjusted";"5. Optimal adjusted";509;393;112;281;546;454
"3055";"1. Random";"1. Random";510;430;103;327;490;510
"3056";"6. Biased  coin";"6. Biased  coin";510;424;101;323;501;502
"3057";"2. Neyman known";"2. Neyman known";510;449;89;360;445;555
"3058";"3. RSIHR Known";"3. RSIHR Known";510;486;78;408;358;642
"3059";"4. Rosenberger known";"4. Rosenberger known";510;577;35;542;149;851
"3060";"5. Optimal adjusted";"5. Optimal adjusted";510;384;103;281;547;453
"3061";"1. Random";"1. Random";511;377;92;285;519;481
"3062";"6. Biased  coin";"6. Biased  coin";511;402;97;305;502;500
"3063";"2. Neyman known";"2. Neyman known";511;411;92;319;457;543
"3064";"3. RSIHR Known";"3. RSIHR Known";511;444;78;366;384;616
"3065";"4. Rosenberger known";"4. Rosenberger known";511;526;26;500;139;861
"3066";"5. Optimal adjusted";"5. Optimal adjusted";511;381;100;281;529;471
"3067";"1. Random";"1. Random";512;378;78;300;529;471
"3068";"6. Biased  coin";"6. Biased  coin";512;377;87;290;504;498
"3069";"2. Neyman known";"2. Neyman known";512;396;80;316;463;537
"3070";"3. RSIHR Known";"3. RSIHR Known";512;443;68;375;375;625
"3071";"4. Rosenberger known";"4. Rosenberger known";512;546;27;519;156;844
"3072";"5. Optimal adjusted";"5. Optimal adjusted";512;368;95;273;550;450
"3073";"1. Random";"1. Random";513;402;90;312;482;518
"3074";"6. Biased  coin";"6. Biased  coin";513;396;91;305;500;500
"3075";"2. Neyman known";"2. Neyman known";513;416;93;323;471;529
"3076";"3. RSIHR Known";"3. RSIHR Known";513;450;66;384;372;628
"3077";"4. Rosenberger known";"4. Rosenberger known";513;545;25;520;129;871
"3078";"5. Optimal adjusted";"5. Optimal adjusted";513;384;95;289;525;475
"3079";"1. Random";"1. Random";514;421;112;309;500;500
"3080";"6. Biased  coin";"6. Biased  coin";514;388;99;289;503;498
"3081";"2. Neyman known";"2. Neyman known";514;403;97;306;449;551
"3082";"3. RSIHR Known";"3. RSIHR Known";514;461;86;375;351;649
"3083";"4. Rosenberger known";"4. Rosenberger known";514;527;34;493;145;855
"3084";"5. Optimal adjusted";"5. Optimal adjusted";514;360;100;260;526;474
"3085";"1. Random";"1. Random";515;379;92;287;501;499
"3086";"6. Biased  coin";"6. Biased  coin";515;377;94;283;500;500
"3087";"2. Neyman known";"2. Neyman known";515;410;89;321;444;556
"3088";"3. RSIHR Known";"3. RSIHR Known";515;457;70;387;339;661
"3089";"4. Rosenberger known";"4. Rosenberger known";515;523;22;501;143;857
"3090";"5. Optimal adjusted";"5. Optimal adjusted";515;366;109;257;554;446
"3091";"1. Random";"1. Random";516;409;104;305;495;505
"3092";"6. Biased  coin";"6. Biased  coin";516;396;107;289;502;498
"3093";"2. Neyman known";"2. Neyman known";516;423;87;336;441;559
"3094";"3. RSIHR Known";"3. RSIHR Known";516;456;79;377;356;644
"3095";"4. Rosenberger known";"4. Rosenberger known";516;545;29;516;140;860
"3096";"5. Optimal adjusted";"5. Optimal adjusted";516;380;104;276;527;473
"3097";"1. Random";"1. Random";517;391;104;287;509;491
"3098";"6. Biased  coin";"6. Biased  coin";517;386;85;301;501;501
"3099";"2. Neyman known";"2. Neyman known";517;424;98;326;477;523
"3100";"3. RSIHR Known";"3. RSIHR Known";517;470;77;393;374;626
"3101";"4. Rosenberger known";"4. Rosenberger known";517;555;31;524;138;862
"3102";"5. Optimal adjusted";"5. Optimal adjusted";517;388;116;272;556;444
"3103";"1. Random";"1. Random";518;372;100;272;520;480
"3104";"6. Biased  coin";"6. Biased  coin";518;380;91;289;501;499
"3105";"2. Neyman known";"2. Neyman known";518;411;82;329;445;555
"3106";"3. RSIHR Known";"3. RSIHR Known";518;435;68;367;359;641
"3107";"4. Rosenberger known";"4. Rosenberger known";518;542;25;517;146;854
"3108";"5. Optimal adjusted";"5. Optimal adjusted";518;356;94;262;555;445
"3109";"1. Random";"1. Random";519;390;104;286;514;486
"3110";"6. Biased  coin";"6. Biased  coin";519;388;103;285;504;497
"3111";"2. Neyman known";"2. Neyman known";519;420;91;329;453;547
"3112";"3. RSIHR Known";"3. RSIHR Known";519;437;72;365;380;620
"3113";"4. Rosenberger known";"4. Rosenberger known";519;544;27;517;138;862
"3114";"5. Optimal adjusted";"5. Optimal adjusted";519;373;109;264;547;453
"3115";"1. Random";"1. Random";520;429;101;328;477;523
"3116";"6. Biased  coin";"6. Biased  coin";520;387;84;303;503;498
"3117";"2. Neyman known";"2. Neyman known";520;415;86;329;472;528
"3118";"3. RSIHR Known";"3. RSIHR Known";520;464;66;398;369;631
"3119";"4. Rosenberger known";"4. Rosenberger known";520;567;28;539;130;870
"3120";"5. Optimal adjusted";"5. Optimal adjusted";520;402;108;294;533;467
"3121";"1. Random";"1. Random";521;402;88;314;483;517
"3122";"6. Biased  coin";"6. Biased  coin";521;418;106;312;503;497
"3123";"2. Neyman known";"2. Neyman known";521;420;79;341;445;555
"3124";"3. RSIHR Known";"3. RSIHR Known";521;452;60;392;370;630
"3125";"4. Rosenberger known";"4. Rosenberger known";521;564;29;535;129;871
"3126";"5. Optimal adjusted";"5. Optimal adjusted";521;386;105;281;561;439
"3127";"1. Random";"1. Random";522;407;96;311;502;498
"3128";"6. Biased  coin";"6. Biased  coin";522;388;90;298;500;501
"3129";"2. Neyman known";"2. Neyman known";522;401;78;323;466;534
"3130";"3. RSIHR Known";"3. RSIHR Known";522;434;52;382;356;644
"3131";"4. Rosenberger known";"4. Rosenberger known";522;542;23;519;141;859
"3132";"5. Optimal adjusted";"5. Optimal adjusted";522;376;101;275;550;450
"3133";"1. Random";"1. Random";523;397;89;308;489;511
"3134";"6. Biased  coin";"6. Biased  coin";523;406;93;313;500;500
"3135";"2. Neyman known";"2. Neyman known";523;446;79;367;407;593
"3136";"3. RSIHR Known";"3. RSIHR Known";523;450;82;368;368;632
"3137";"4. Rosenberger known";"4. Rosenberger known";523;533;24;509;146;854
"3138";"5. Optimal adjusted";"5. Optimal adjusted";523;341;89;252;560;440
"3139";"1. Random";"1. Random";524;378;85;293;493;507
"3140";"6. Biased  coin";"6. Biased  coin";524;382;90;292;500;501
"3141";"2. Neyman known";"2. Neyman known";524;391;87;304;478;522
"3142";"3. RSIHR Known";"3. RSIHR Known";524;440;73;367;369;631
"3143";"4. Rosenberger known";"4. Rosenberger known";524;522;24;498;145;855
"3144";"5. Optimal adjusted";"5. Optimal adjusted";524;378;102;276;544;456
"3145";"1. Random";"1. Random";525;362;89;273;524;476
"3146";"6. Biased  coin";"6. Biased  coin";525;389;86;303;501;500
"3147";"2. Neyman known";"2. Neyman known";525;410;69;341;443;557
"3148";"3. RSIHR Known";"3. RSIHR Known";525;453;72;381;350;650
"3149";"4. Rosenberger known";"4. Rosenberger known";525;526;17;509;142;858
"3150";"5. Optimal adjusted";"5. Optimal adjusted";525;368;87;281;553;447
"3151";"1. Random";"1. Random";526;422;87;335;472;528
"3152";"6. Biased  coin";"6. Biased  coin";526;419;107;312;505;497
"3153";"2. Neyman known";"2. Neyman known";526;418;87;331;452;548
"3154";"3. RSIHR Known";"3. RSIHR Known";526;455;71;384;357;643
"3155";"4. Rosenberger known";"4. Rosenberger known";526;552;26;526;143;857
"3156";"5. Optimal adjusted";"5. Optimal adjusted";526;368;104;264;573;427
"3157";"1. Random";"1. Random";527;409;98;311;489;511
"3158";"6. Biased  coin";"6. Biased  coin";527;394;106;288;499;502
"3159";"2. Neyman known";"2. Neyman known";527;409;93;316;467;533
"3160";"3. RSIHR Known";"3. RSIHR Known";527;479;84;395;343;657
"3161";"4. Rosenberger known";"4. Rosenberger known";527;521;27;494;160;840
"3162";"5. Optimal adjusted";"5. Optimal adjusted";527;399;115;284;517;483
"3163";"1. Random";"1. Random";528;393;91;302;508;492
"3164";"6. Biased  coin";"6. Biased  coin";528;407;94;313;502;500
"3165";"2. Neyman known";"2. Neyman known";528;415;69;346;434;566
"3166";"3. RSIHR Known";"3. RSIHR Known";528;472;67;405;357;643
"3167";"4. Rosenberger known";"4. Rosenberger known";528;564;29;535;141;859
"3168";"5. Optimal adjusted";"5. Optimal adjusted";528;406;104;302;524;476
"3169";"1. Random";"1. Random";529;440;92;348;468;532
"3170";"6. Biased  coin";"6. Biased  coin";529;432;104;328;503;499
"3171";"2. Neyman known";"2. Neyman known";529;451;87;364;429;571
"3172";"3. RSIHR Known";"3. RSIHR Known";529;469;65;404;340;660
"3173";"4. Rosenberger known";"4. Rosenberger known";529;553;26;527;156;844
"3174";"5. Optimal adjusted";"5. Optimal adjusted";529;398;99;299;527;473
"3175";"1. Random";"1. Random";530;386;98;288;518;482
"3176";"6. Biased  coin";"6. Biased  coin";530;388;95;293;501;499
"3177";"2. Neyman known";"2. Neyman known";530;405;79;326;454;546
"3178";"3. RSIHR Known";"3. RSIHR Known";530;444;68;376;367;633
"3179";"4. Rosenberger known";"4. Rosenberger known";530;537;27;510;151;849
"3180";"5. Optimal adjusted";"5. Optimal adjusted";530;382;94;288;533;467
"3181";"1. Random";"1. Random";531;402;104;298;528;472
"3182";"6. Biased  coin";"6. Biased  coin";531;402;96;306;506;499
"3183";"2. Neyman known";"2. Neyman known";531;418;76;342;453;547
"3184";"3. RSIHR Known";"3. RSIHR Known";531;467;72;395;367;633
"3185";"4. Rosenberger known";"4. Rosenberger known";531;541;21;520;144;856
"3186";"5. Optimal adjusted";"5. Optimal adjusted";531;387;104;283;525;475
"3187";"1. Random";"1. Random";532;396;84;312;497;503
"3188";"6. Biased  coin";"6. Biased  coin";532;392;81;311;500;500
"3189";"2. Neyman known";"2. Neyman known";532;441;100;341;461;539
"3190";"3. RSIHR Known";"3. RSIHR Known";532;464;61;403;350;650
"3191";"4. Rosenberger known";"4. Rosenberger known";532;545;27;518;158;842
"3192";"5. Optimal adjusted";"5. Optimal adjusted";532;381;94;287;542;458
"3193";"1. Random";"1. Random";533;403;90;313;494;506
"3194";"6. Biased  coin";"6. Biased  coin";533;392;101;291;500;501
"3195";"2. Neyman known";"2. Neyman known";533;414;75;339;425;575
"3196";"3. RSIHR Known";"3. RSIHR Known";533;430;68;362;380;620
"3197";"4. Rosenberger known";"4. Rosenberger known";533;527;33;494;162;838
"3198";"5. Optimal adjusted";"5. Optimal adjusted";533;375;87;288;506;494
"3199";"1. Random";"1. Random";534;408;116;292;542;458
"3200";"6. Biased  coin";"6. Biased  coin";534;399;102;297;502;499
"3201";"2. Neyman known";"2. Neyman known";534;443;98;345;434;566
"3202";"3. RSIHR Known";"3. RSIHR Known";534;457;73;384;376;624
"3203";"4. Rosenberger known";"4. Rosenberger known";534;550;34;516;144;856
"3204";"5. Optimal adjusted";"5. Optimal adjusted";534;401;124;277;534;466
"3205";"1. Random";"1. Random";535;389;89;300;489;511
"3206";"6. Biased  coin";"6. Biased  coin";535;408;104;304;501;500
"3207";"2. Neyman known";"2. Neyman known";535;397;88;309;471;529
"3208";"3. RSIHR Known";"3. RSIHR Known";535;452;73;379;371;629
"3209";"4. Rosenberger known";"4. Rosenberger known";535;552;31;521;156;844
"3210";"5. Optimal adjusted";"5. Optimal adjusted";535;382;110;272;566;434
"3211";"1. Random";"1. Random";536;407;100;307;489;511
"3212";"6. Biased  coin";"6. Biased  coin";536;402;102;300;502;501
"3213";"2. Neyman known";"2. Neyman known";536;460;93;367;414;586
"3214";"3. RSIHR Known";"3. RSIHR Known";536;473;79;394;358;642
"3215";"4. Rosenberger known";"4. Rosenberger known";536;545;27;518;135;865
"3216";"5. Optimal adjusted";"5. Optimal adjusted";536;399;110;289;524;476
"3217";"1. Random";"1. Random";537;412;107;305;519;481
"3218";"6. Biased  coin";"6. Biased  coin";537;417;111;306;504;499
"3219";"2. Neyman known";"2. Neyman known";537;433;78;355;432;568
"3220";"3. RSIHR Known";"3. RSIHR Known";537;469;79;390;362;638
"3221";"4. Rosenberger known";"4. Rosenberger known";537;541;33;508;158;842
"3222";"5. Optimal adjusted";"5. Optimal adjusted";537;374;103;271;539;461
"3223";"1. Random";"1. Random";538;416;101;315;500;500
"3224";"6. Biased  coin";"6. Biased  coin";538;414;108;306;500;500
"3225";"2. Neyman known";"2. Neyman known";538;433;88;345;422;578
"3226";"3. RSIHR Known";"3. RSIHR Known";538;446;69;377;378;622
"3227";"4. Rosenberger known";"4. Rosenberger known";538;563;33;530;135;865
"3228";"5. Optimal adjusted";"5. Optimal adjusted";538;399;103;296;520;480
"3229";"1. Random";"1. Random";539;379;78;301;503;497
"3230";"6. Biased  coin";"6. Biased  coin";539;397;83;314;501;499
"3231";"2. Neyman known";"2. Neyman known";539;423;87;336;466;534
"3232";"3. RSIHR Known";"3. RSIHR Known";539;461;68;393;370;630
"3233";"4. Rosenberger known";"4. Rosenberger known";539;551;22;529;134;866
"3234";"5. Optimal adjusted";"5. Optimal adjusted";539;387;86;301;521;479
"3235";"1. Random";"1. Random";540;400;101;299;507;493
"3236";"6. Biased  coin";"6. Biased  coin";540;411;101;310;500;500
"3237";"2. Neyman known";"2. Neyman known";540;417;93;324;454;546
"3238";"3. RSIHR Known";"3. RSIHR Known";540;446;68;378;373;627
"3239";"4. Rosenberger known";"4. Rosenberger known";540;558;30;528;138;862
"3240";"5. Optimal adjusted";"5. Optimal adjusted";540;394;107;287;522;478
"3241";"1. Random";"1. Random";541;426;109;317;496;504
"3242";"6. Biased  coin";"6. Biased  coin";541;412;95;317;500;500
"3243";"2. Neyman known";"2. Neyman known";541;422;91;331;449;551
"3244";"3. RSIHR Known";"3. RSIHR Known";541;470;62;408;351;649
"3245";"4. Rosenberger known";"4. Rosenberger known";541;579;35;544;143;857
"3246";"5. Optimal adjusted";"5. Optimal adjusted";541;401;108;293;530;470
"3247";"1. Random";"1. Random";542;390;96;294;502;498
"3248";"6. Biased  coin";"6. Biased  coin";542;384;91;293;500;500
"3249";"2. Neyman known";"2. Neyman known";542;415;77;338;439;561
"3250";"3. RSIHR Known";"3. RSIHR Known";542;435;69;366;373;627
"3251";"4. Rosenberger known";"4. Rosenberger known";542;511;26;485;157;843
"3252";"5. Optimal adjusted";"5. Optimal adjusted";542;339;96;243;549;451
"3253";"1. Random";"1. Random";543;396;100;296;498;502
"3254";"6. Biased  coin";"6. Biased  coin";543;374;89;285;501;500
"3255";"2. Neyman known";"2. Neyman known";543;416;98;318;460;540
"3256";"3. RSIHR Known";"3. RSIHR Known";543;451;69;382;362;638
"3257";"4. Rosenberger known";"4. Rosenberger known";543;549;37;512;144;856
"3258";"5. Optimal adjusted";"5. Optimal adjusted";543;401;116;285;531;469
"3259";"1. Random";"1. Random";544;406;91;315;457;543
"3260";"6. Biased  coin";"6. Biased  coin";544;402;100;302;500;500
"3261";"2. Neyman known";"2. Neyman known";544;401;91;310;459;541
"3262";"3. RSIHR Known";"3. RSIHR Known";544;446;67;379;352;648
"3263";"4. Rosenberger known";"4. Rosenberger known";544;528;20;508;134;866
"3264";"5. Optimal adjusted";"5. Optimal adjusted";544;394;106;288;531;469
"3265";"1. Random";"1. Random";545;410;112;298;492;508
"3266";"6. Biased  coin";"6. Biased  coin";545;405;105;300;501;500
"3267";"2. Neyman known";"2. Neyman known";545;460;88;372;411;589
"3268";"3. RSIHR Known";"3. RSIHR Known";545;475;73;402;351;649
"3269";"4. Rosenberger known";"4. Rosenberger known";545;551;27;524;147;853
"3270";"5. Optimal adjusted";"5. Optimal adjusted";545;416;115;301;522;478
"3271";"1. Random";"1. Random";546;426;112;314;515;485
"3272";"6. Biased  coin";"6. Biased  coin";546;398;94;304;500;501
"3273";"2. Neyman known";"2. Neyman known";546;415;83;332;440;560
"3274";"3. RSIHR Known";"3. RSIHR Known";546;468;82;386;374;626
"3275";"4. Rosenberger known";"4. Rosenberger known";546;547;26;521;138;862
"3276";"5. Optimal adjusted";"5. Optimal adjusted";546;381;105;276;540;460
"3277";"1. Random";"1. Random";547;408;112;296;504;496
"3278";"6. Biased  coin";"6. Biased  coin";547;396;94;302;501;500
"3279";"2. Neyman known";"2. Neyman known";547;428;95;333;449;551
"3280";"3. RSIHR Known";"3. RSIHR Known";547;466;79;387;361;639
"3281";"4. Rosenberger known";"4. Rosenberger known";547;542;32;510;148;852
"3282";"5. Optimal adjusted";"5. Optimal adjusted";547;404;115;289;520;480
"3283";"1. Random";"1. Random";548;420;110;310;506;494
"3284";"6. Biased  coin";"6. Biased  coin";548;427;112;315;500;501
"3285";"2. Neyman known";"2. Neyman known";548;459;120;339;469;531
"3286";"3. RSIHR Known";"3. RSIHR Known";548;482;83;399;370;630
"3287";"4. Rosenberger known";"4. Rosenberger known";548;569;16;553;129;871
"3288";"5. Optimal adjusted";"5. Optimal adjusted";548;426;114;312;518;482
"3289";"1. Random";"1. Random";549;377;81;296;470;530
"3290";"6. Biased  coin";"6. Biased  coin";549;371;101;270;501;499
"3291";"2. Neyman known";"2. Neyman known";549;401;94;307;460;540
"3292";"3. RSIHR Known";"3. RSIHR Known";549;448;69;379;334;666
"3293";"4. Rosenberger known";"4. Rosenberger known";549;518;21;497;126;874
"3294";"5. Optimal adjusted";"5. Optimal adjusted";549;378;118;260;543;457
"3295";"1. Random";"1. Random";550;387;101;286;517;483
"3296";"6. Biased  coin";"6. Biased  coin";550;415;107;308;501;499
"3297";"2. Neyman known";"2. Neyman known";550;442;96;346;431;569
"3298";"3. RSIHR Known";"3. RSIHR Known";550;494;84;410;365;635
"3299";"4. Rosenberger known";"4. Rosenberger known";550;560;39;521;155;845
"3300";"5. Optimal adjusted";"5. Optimal adjusted";550;431;121;310;507;493
"3301";"1. Random";"1. Random";551;420;91;329;475;525
"3302";"6. Biased  coin";"6. Biased  coin";551;393;90;303;500;500
"3303";"2. Neyman known";"2. Neyman known";551;458;85;373;418;582
"3304";"3. RSIHR Known";"3. RSIHR Known";551;467;60;407;379;621
"3305";"4. Rosenberger known";"4. Rosenberger known";551;556;26;530;153;847
"3306";"5. Optimal adjusted";"5. Optimal adjusted";551;395;99;296;522;478
"3307";"1. Random";"1. Random";552;384;103;281;524;476
"3308";"6. Biased  coin";"6. Biased  coin";552;394;105;289;501;500
"3309";"2. Neyman known";"2. Neyman known";552;413;91;322;447;553
"3310";"3. RSIHR Known";"3. RSIHR Known";552;421;63;358;365;635
"3311";"4. Rosenberger known";"4. Rosenberger known";552;523;25;498;133;867
"3312";"5. Optimal adjusted";"5. Optimal adjusted";552;362;99;263;524;476
"3313";"1. Random";"1. Random";553;396;92;304;518;482
"3314";"6. Biased  coin";"6. Biased  coin";553;429;103;326;503;498
"3315";"2. Neyman known";"2. Neyman known";553;425;84;341;451;549
"3316";"3. RSIHR Known";"3. RSIHR Known";553;475;76;399;362;638
"3317";"4. Rosenberger known";"4. Rosenberger known";553;567;24;543;144;856
"3318";"5. Optimal adjusted";"5. Optimal adjusted";553;418;99;319;505;495
"3319";"1. Random";"1. Random";554;405;106;299;511;489
"3320";"6. Biased  coin";"6. Biased  coin";554;406;95;311;499;501
"3321";"2. Neyman known";"2. Neyman known";554;436;92;344;460;540
"3322";"3. RSIHR Known";"3. RSIHR Known";554;447;84;363;391;609
"3323";"4. Rosenberger known";"4. Rosenberger known";554;556;28;528;142;858
"3324";"5. Optimal adjusted";"5. Optimal adjusted";554;391;109;282;542;458
"3325";"1. Random";"1. Random";555;383;92;291;488;512
"3326";"6. Biased  coin";"6. Biased  coin";555;403;103;300;501;500
"3327";"2. Neyman known";"2. Neyman known";555;393;77;316;441;559
"3328";"3. RSIHR Known";"3. RSIHR Known";555;459;68;391;370;630
"3329";"4. Rosenberger known";"4. Rosenberger known";555;536;23;513;139;861
"3330";"5. Optimal adjusted";"5. Optimal adjusted";555;358;103;255;564;436
"3331";"1. Random";"1. Random";556;413;98;315;483;517
"3332";"6. Biased  coin";"6. Biased  coin";556;415;110;305;501;501
"3333";"2. Neyman known";"2. Neyman known";556;439;104;335;448;552
"3334";"3. RSIHR Known";"3. RSIHR Known";556;450;71;379;377;623
"3335";"4. Rosenberger known";"4. Rosenberger known";556;547;40;507;162;838
"3336";"5. Optimal adjusted";"5. Optimal adjusted";556;383;111;272;535;465
"3337";"1. Random";"1. Random";557;386;102;284;504;496
"3338";"6. Biased  coin";"6. Biased  coin";557;390;100;290;501;500
"3339";"2. Neyman known";"2. Neyman known";557;410;86;324;450;550
"3340";"3. RSIHR Known";"3. RSIHR Known";557;456;80;376;347;653
"3341";"4. Rosenberger known";"4. Rosenberger known";557;538;30;508;130;870
"3342";"5. Optimal adjusted";"5. Optimal adjusted";557;399;119;280;536;464
"3343";"1. Random";"1. Random";558;431;128;303;515;485
"3344";"6. Biased  coin";"6. Biased  coin";558;416;113;303;501;500
"3345";"2. Neyman known";"2. Neyman known";558;421;93;328;459;541
"3346";"3. RSIHR Known";"3. RSIHR Known";558;476;81;395;349;651
"3347";"4. Rosenberger known";"4. Rosenberger known";558;562;31;531;144;856
"3348";"5. Optimal adjusted";"5. Optimal adjusted";558;399;115;284;537;463
"3349";"1. Random";"1. Random";559;423;109;314;488;512
"3350";"6. Biased  coin";"6. Biased  coin";559;430;119;311;499;501
"3351";"2. Neyman known";"2. Neyman known";559;422;90;332;437;563
"3352";"3. RSIHR Known";"3. RSIHR Known";559;463;77;386;382;618
"3353";"4. Rosenberger known";"4. Rosenberger known";559;557;29;528;140;860
"3354";"5. Optimal adjusted";"5. Optimal adjusted";559;408;118;290;531;469
"3355";"1. Random";"1. Random";560;386;95;291;516;484
"3356";"6. Biased  coin";"6. Biased  coin";560;379;94;285;502;498
"3357";"2. Neyman known";"2. Neyman known";560;402;90;312;474;526
"3358";"3. RSIHR Known";"3. RSIHR Known";560;448;66;382;339;661
"3359";"4. Rosenberger known";"4. Rosenberger known";560;521;24;497;150;850
"3360";"5. Optimal adjusted";"5. Optimal adjusted";560;387;102;285;534;466
"3361";"1. Random";"1. Random";561;395;90;305;503;497
"3362";"6. Biased  coin";"6. Biased  coin";561;382;90;292;501;500
"3363";"2. Neyman known";"2. Neyman known";561;436;86;350;414;586
"3364";"3. RSIHR Known";"3. RSIHR Known";561;443;68;375;361;639
"3365";"4. Rosenberger known";"4. Rosenberger known";561;539;33;506;171;829
"3366";"5. Optimal adjusted";"5. Optimal adjusted";561;381;108;273;562;438
"3367";"1. Random";"1. Random";562;400;100;300;492;508
"3368";"6. Biased  coin";"6. Biased  coin";562;407;94;313;502;499
"3369";"2. Neyman known";"2. Neyman known";562;438;102;336;448;552
"3370";"3. RSIHR Known";"3. RSIHR Known";562;469;81;388;354;646
"3371";"4. Rosenberger known";"4. Rosenberger known";562;561;29;532;138;862
"3372";"5. Optimal adjusted";"5. Optimal adjusted";562;408;113;295;533;467
"3373";"1. Random";"1. Random";563;420;91;329;482;518
"3374";"6. Biased  coin";"6. Biased  coin";563;398;93;305;501;501
"3375";"2. Neyman known";"2. Neyman known";563;421;77;344;446;554
"3376";"3. RSIHR Known";"3. RSIHR Known";563;445;64;381;385;615
"3377";"4. Rosenberger known";"4. Rosenberger known";563;568;25;543;141;859
"3378";"5. Optimal adjusted";"5. Optimal adjusted";563;386;102;284;530;470
"3379";"1. Random";"1. Random";564;421;112;309;476;524
"3380";"6. Biased  coin";"6. Biased  coin";564;423;110;313;499;501
"3381";"2. Neyman known";"2. Neyman known";564;414;80;334;449;551
"3382";"3. RSIHR Known";"3. RSIHR Known";564;462;79;383;375;625
"3383";"4. Rosenberger known";"4. Rosenberger known";564;547;25;522;141;859
"3384";"5. Optimal adjusted";"5. Optimal adjusted";564;399;114;285;525;475
"3385";"1. Random";"1. Random";565;392;89;303;502;498
"3386";"6. Biased  coin";"6. Biased  coin";565;379;92;287;500;500
"3387";"2. Neyman known";"2. Neyman known";565;431;87;344;441;559
"3388";"3. RSIHR Known";"3. RSIHR Known";565;433;67;366;379;621
"3389";"4. Rosenberger known";"4. Rosenberger known";565;534;29;505;169;831
"3390";"5. Optimal adjusted";"5. Optimal adjusted";565;397;87;310;523;477
"3391";"1. Random";"1. Random";566;414;100;314;491;509
"3392";"6. Biased  coin";"6. Biased  coin";566;411;111;300;501;499
"3393";"2. Neyman known";"2. Neyman known";566;404;93;311;479;521
"3394";"3. RSIHR Known";"3. RSIHR Known";566;448;71;377;374;626
"3395";"4. Rosenberger known";"4. Rosenberger known";566;550;31;519;143;857
"3396";"5. Optimal adjusted";"5. Optimal adjusted";566;393;108;285;532;468
"3397";"1. Random";"1. Random";567;426;112;314;506;494
"3398";"6. Biased  coin";"6. Biased  coin";567;413;105;308;500;500
"3399";"2. Neyman known";"2. Neyman known";567;457;89;368;417;583
"3400";"3. RSIHR Known";"3. RSIHR Known";567;463;76;387;358;642
"3401";"4. Rosenberger known";"4. Rosenberger known";567;565;35;530;149;851
"3402";"5. Optimal adjusted";"5. Optimal adjusted";567;391;115;276;548;452
"3403";"1. Random";"1. Random";568;399;110;289;516;484
"3404";"6. Biased  coin";"6. Biased  coin";568;393;87;306;500;500
"3405";"2. Neyman known";"2. Neyman known";568;422;94;328;455;545
"3406";"3. RSIHR Known";"3. RSIHR Known";568;469;74;395;351;649
"3407";"4. Rosenberger known";"4. Rosenberger known";568;556;40;516;161;839
"3408";"5. Optimal adjusted";"5. Optimal adjusted";568;407;114;293;518;482
"3409";"1. Random";"1. Random";569;413;100;313;485;515
"3410";"6. Biased  coin";"6. Biased  coin";569;393;99;294;500;500
"3411";"2. Neyman known";"2. Neyman known";569;414;88;326;445;555
"3412";"3. RSIHR Known";"3. RSIHR Known";569;436;83;353;389;611
"3413";"4. Rosenberger known";"4. Rosenberger known";569;545;34;511;145;855
"3414";"5. Optimal adjusted";"5. Optimal adjusted";569;400;119;281;536;464
"3415";"1. Random";"1. Random";570;401;97;304;493;507
"3416";"6. Biased  coin";"6. Biased  coin";570;408;106;302;498;502
"3417";"2. Neyman known";"2. Neyman known";570;414;77;337;438;562
"3418";"3. RSIHR Known";"3. RSIHR Known";570;438;70;368;386;614
"3419";"4. Rosenberger known";"4. Rosenberger known";570;537;35;502;148;852
"3420";"5. Optimal adjusted";"5. Optimal adjusted";570;347;111;236;579;421
"3421";"1. Random";"1. Random";571;376;87;289;522;478
"3422";"6. Biased  coin";"6. Biased  coin";571;401;101;300;500;500
"3423";"2. Neyman known";"2. Neyman known";571;411;88;323;457;543
"3424";"3. RSIHR Known";"3. RSIHR Known";571;448;74;374;382;618
"3425";"4. Rosenberger known";"4. Rosenberger known";571;538;24;514;143;857
"3426";"5. Optimal adjusted";"5. Optimal adjusted";571;370;100;270;537;463
"3427";"1. Random";"1. Random";572;405;97;308;502;498
"3428";"6. Biased  coin";"6. Biased  coin";572;414;95;319;499;501
"3429";"2. Neyman known";"2. Neyman known";572;440;101;339;465;535
"3430";"3. RSIHR Known";"3. RSIHR Known";572;495;76;419;337;663
"3431";"4. Rosenberger known";"4. Rosenberger known";572;582;34;548;137;863
"3432";"5. Optimal adjusted";"5. Optimal adjusted";572;418;119;299;525;475
"3433";"1. Random";"1. Random";573;420;96;324;484;516
"3434";"6. Biased  coin";"6. Biased  coin";573;397;97;300;500;500
"3435";"2. Neyman known";"2. Neyman known";573;431;93;338;453;547
"3436";"3. RSIHR Known";"3. RSIHR Known";573;451;75;376;387;613
"3437";"4. Rosenberger known";"4. Rosenberger known";573;582;31;551;134;866
"3438";"5. Optimal adjusted";"5. Optimal adjusted";573;392;107;285;548;452
"3439";"1. Random";"1. Random";574;386;85;301;499;501
"3440";"6. Biased  coin";"6. Biased  coin";574;380;83;297;501;499
"3441";"2. Neyman known";"2. Neyman known";574;408;73;335;461;539
"3442";"3. RSIHR Known";"3. RSIHR Known";574;448;62;386;378;622
"3443";"4. Rosenberger known";"4. Rosenberger known";574;518;23;495;155;845
"3444";"5. Optimal adjusted";"5. Optimal adjusted";574;362;91;271;552;448
"3445";"1. Random";"1. Random";575;420;109;311;501;499
"3446";"6. Biased  coin";"6. Biased  coin";575;424;108;316;501;500
"3447";"2. Neyman known";"2. Neyman known";575;426;97;329;468;532
"3448";"3. RSIHR Known";"3. RSIHR Known";575;466;72;394;354;646
"3449";"4. Rosenberger known";"4. Rosenberger known";575;557;31;526;158;842
"3450";"5. Optimal adjusted";"5. Optimal adjusted";575;401;105;296;520;480
"3451";"1. Random";"1. Random";576;414;114;300;498;502
"3452";"6. Biased  coin";"6. Biased  coin";576;410;111;299;500;500
"3453";"2. Neyman known";"2. Neyman known";576;403;76;327;431;569
"3454";"3. RSIHR Known";"3. RSIHR Known";576;448;77;371;369;631
"3455";"4. Rosenberger known";"4. Rosenberger known";576;532;28;504;141;859
"3456";"5. Optimal adjusted";"5. Optimal adjusted";576;380;94;286;521;479
"3457";"1. Random";"1. Random";577;391;106;285;519;481
"3458";"6. Biased  coin";"6. Biased  coin";577;404;106;298;498;502
"3459";"2. Neyman known";"2. Neyman known";577;437;99;338;446;554
"3460";"3. RSIHR Known";"3. RSIHR Known";577;439;65;374;371;629
"3461";"4. Rosenberger known";"4. Rosenberger known";577;538;20;518;139;861
"3462";"5. Optimal adjusted";"5. Optimal adjusted";577;373;93;280;518;482
"3463";"1. Random";"1. Random";578;390;114;276;523;477
"3464";"6. Biased  coin";"6. Biased  coin";578;394;87;307;502;500
"3465";"2. Neyman known";"2. Neyman known";578;422;88;334;454;546
"3466";"3. RSIHR Known";"3. RSIHR Known";578;449;71;378;357;643
"3467";"4. Rosenberger known";"4. Rosenberger known";578;532;35;497;157;843
"3468";"5. Optimal adjusted";"5. Optimal adjusted";578;396;110;286;511;489
"3469";"1. Random";"1. Random";579;381;93;288;488;512
"3470";"6. Biased  coin";"6. Biased  coin";579;407;105;302;500;500
"3471";"2. Neyman known";"2. Neyman known";579;415;92;323;469;531
"3472";"3. RSIHR Known";"3. RSIHR Known";579;471;77;394;370;630
"3473";"4. Rosenberger known";"4. Rosenberger known";579;551;31;520;138;862
"3474";"5. Optimal adjusted";"5. Optimal adjusted";579;380;105;275;538;462
"3475";"1. Random";"1. Random";580;406;104;302;515;485
"3476";"6. Biased  coin";"6. Biased  coin";580;405;91;314;501;500
"3477";"2. Neyman known";"2. Neyman known";580;437;94;343;441;559
"3478";"3. RSIHR Known";"3. RSIHR Known";580;457;67;390;364;636
"3479";"4. Rosenberger known";"4. Rosenberger known";580;556;31;525;150;850
"3480";"5. Optimal adjusted";"5. Optimal adjusted";580;398;109;289;543;457
"3481";"1. Random";"1. Random";581;399;104;295;486;514
"3482";"6. Biased  coin";"6. Biased  coin";581;403;109;294;499;501
"3483";"2. Neyman known";"2. Neyman known";581;426;103;323;449;551
"3484";"3. RSIHR Known";"3. RSIHR Known";581;452;74;378;365;635
"3485";"4. Rosenberger known";"4. Rosenberger known";581;554;27;527;136;864
"3486";"5. Optimal adjusted";"5. Optimal adjusted";581;415;125;290;537;463
"3487";"1. Random";"1. Random";582;384;85;299;483;517
"3488";"6. Biased  coin";"6. Biased  coin";582;372;84;288;501;499
"3489";"2. Neyman known";"2. Neyman known";582;403;88;315;455;545
"3490";"3. RSIHR Known";"3. RSIHR Known";582;428;62;366;396;604
"3491";"4. Rosenberger known";"4. Rosenberger known";582;533;22;511;128;872
"3492";"5. Optimal adjusted";"5. Optimal adjusted";582;398;106;292;489;511
"3493";"1. Random";"1. Random";583;393;94;299;496;504
"3494";"6. Biased  coin";"6. Biased  coin";583;418;105;313;502;500
"3495";"2. Neyman known";"2. Neyman known";583;420;87;333;447;553
"3496";"3. RSIHR Known";"3. RSIHR Known";583;453;72;381;370;630
"3497";"4. Rosenberger known";"4. Rosenberger known";583;549;22;527;147;853
"3498";"5. Optimal adjusted";"5. Optimal adjusted";583;399;106;293;520;480
"3499";"1. Random";"1. Random";584;408;89;319;512;488
"3500";"6. Biased  coin";"6. Biased  coin";584;401;85;316;501;500
"3501";"2. Neyman known";"2. Neyman known";584;458;87;371;431;569
"3502";"3. RSIHR Known";"3. RSIHR Known";584;450;65;385;394;606
"3503";"4. Rosenberger known";"4. Rosenberger known";584;559;26;533;154;846
"3504";"5. Optimal adjusted";"5. Optimal adjusted";584;389;102;287;534;466
"3505";"1. Random";"1. Random";585;413;88;325;485;515
"3506";"6. Biased  coin";"6. Biased  coin";585;375;88;287;500;500
"3507";"2. Neyman known";"2. Neyman known";585;401;80;321;449;551
"3508";"3. RSIHR Known";"3. RSIHR Known";585;467;67;400;358;642
"3509";"4. Rosenberger known";"4. Rosenberger known";585;553;26;527;149;851
"3510";"5. Optimal adjusted";"5. Optimal adjusted";585;398;112;286;549;451
"3511";"1. Random";"1. Random";586;364;103;261;534;466
"3512";"6. Biased  coin";"6. Biased  coin";586;409;100;309;499;502
"3513";"2. Neyman known";"2. Neyman known";586;405;92;313;452;548
"3514";"3. RSIHR Known";"3. RSIHR Known";586;454;83;371;375;625
"3515";"4. Rosenberger known";"4. Rosenberger known";586;531;30;501;134;866
"3516";"5. Optimal adjusted";"5. Optimal adjusted";586;387;112;275;545;455
"3517";"1. Random";"1. Random";587;399;96;303;516;484
"3518";"6. Biased  coin";"6. Biased  coin";587;433;111;322;503;500
"3519";"2. Neyman known";"2. Neyman known";587;415;87;328;449;551
"3520";"3. RSIHR Known";"3. RSIHR Known";587;463;68;395;362;638
"3521";"4. Rosenberger known";"4. Rosenberger known";587;563;37;526;143;857
"3522";"5. Optimal adjusted";"5. Optimal adjusted";587;379;111;268;542;458
"3523";"1. Random";"1. Random";588;396;89;307;499;501
"3524";"6. Biased  coin";"6. Biased  coin";588;376;88;288;500;500
"3525";"2. Neyman known";"2. Neyman known";588;415;75;340;422;578
"3526";"3. RSIHR Known";"3. RSIHR Known";588;461;70;391;360;640
"3527";"4. Rosenberger known";"4. Rosenberger known";588;562;31;531;137;863
"3528";"5. Optimal adjusted";"5. Optimal adjusted";588;397;110;287;529;471
"3529";"1. Random";"1. Random";589;411;102;309;529;471
"3530";"6. Biased  coin";"6. Biased  coin";589;397;95;302;500;500
"3531";"2. Neyman known";"2. Neyman known";589;440;91;349;441;559
"3532";"3. RSIHR Known";"3. RSIHR Known";589;470;77;393;358;642
"3533";"4. Rosenberger known";"4. Rosenberger known";589;575;26;549;125;875
"3534";"5. Optimal adjusted";"5. Optimal adjusted";589;401;115;286;535;465
"3535";"1. Random";"1. Random";590;397;102;295;513;487
"3536";"6. Biased  coin";"6. Biased  coin";590;372;86;286;501;499
"3537";"2. Neyman known";"2. Neyman known";590;439;100;339;466;534
"3538";"3. RSIHR Known";"3. RSIHR Known";590;460;73;387;354;646
"3539";"4. Rosenberger known";"4. Rosenberger known";590;539;26;513;132;868
"3540";"5. Optimal adjusted";"5. Optimal adjusted";590;374;115;259;563;437
"3541";"1. Random";"1. Random";591;413;104;309;490;510
"3542";"6. Biased  coin";"6. Biased  coin";591;413;97;316;501;500
"3543";"2. Neyman known";"2. Neyman known";591;422;83;339;453;547
"3544";"3. RSIHR Known";"3. RSIHR Known";591;463;69;394;367;633
"3545";"4. Rosenberger known";"4. Rosenberger known";591;552;27;525;152;848
"3546";"5. Optimal adjusted";"5. Optimal adjusted";591;401;104;297;526;474
"3547";"1. Random";"1. Random";592;427;120;307;527;473
"3548";"6. Biased  coin";"6. Biased  coin";592;432;110;322;504;497
"3549";"2. Neyman known";"2. Neyman known";592;438;98;340;464;536
"3550";"3. RSIHR Known";"3. RSIHR Known";592;472;89;383;389;611
"3551";"4. Rosenberger known";"4. Rosenberger known";592;591;32;559;129;871
"3552";"5. Optimal adjusted";"5. Optimal adjusted";592;421;125;296;546;454
"3553";"1. Random";"1. Random";593;407;104;303;507;493
"3554";"6. Biased  coin";"6. Biased  coin";593;430;102;328;500;500
"3555";"2. Neyman known";"2. Neyman known";593;448;90;358;431;569
"3556";"3. RSIHR Known";"3. RSIHR Known";593;475;84;391;379;621
"3557";"4. Rosenberger known";"4. Rosenberger known";593;571;32;539;145;855
"3558";"5. Optimal adjusted";"5. Optimal adjusted";593;384;108;276;554;446
"3559";"1. Random";"1. Random";594;397;99;298;513;487
"3560";"6. Biased  coin";"6. Biased  coin";594;403;97;306;498;502
"3561";"2. Neyman known";"2. Neyman known";594;437;85;352;433;567
"3562";"3. RSIHR Known";"3. RSIHR Known";594;461;87;374;382;618
"3563";"4. Rosenberger known";"4. Rosenberger known";594;532;31;501;163;837
"3564";"5. Optimal adjusted";"5. Optimal adjusted";594;358;110;248;563;437
"3565";"1. Random";"1. Random";595;390;86;304;486;514
"3566";"6. Biased  coin";"6. Biased  coin";595;406;97;309;499;501
"3567";"2. Neyman known";"2. Neyman known";595;421;91;330;442;558
"3568";"3. RSIHR Known";"3. RSIHR Known";595;458;64;394;363;637
"3569";"4. Rosenberger known";"4. Rosenberger known";595;538;22;516;132;868
"3570";"5. Optimal adjusted";"5. Optimal adjusted";595;381;99;282;535;465
"3571";"1. Random";"1. Random";596;408;92;316;501;499
"3572";"6. Biased  coin";"6. Biased  coin";596;406;103;303;500;500
"3573";"2. Neyman known";"2. Neyman known";596;440;96;344;457;543
"3574";"3. RSIHR Known";"3. RSIHR Known";596;456;82;374;377;623
"3575";"4. Rosenberger known";"4. Rosenberger known";596;570;37;533;139;861
"3576";"5. Optimal adjusted";"5. Optimal adjusted";596;409;98;311;501;499
"3577";"1. Random";"1. Random";597;398;97;301;492;508
"3578";"6. Biased  coin";"6. Biased  coin";597;402;98;304;503;500
"3579";"2. Neyman known";"2. Neyman known";597;429;92;337;435;565
"3580";"3. RSIHR Known";"3. RSIHR Known";597;459;81;378;393;607
"3581";"4. Rosenberger known";"4. Rosenberger known";597;525;20;505;157;843
"3582";"5. Optimal adjusted";"5. Optimal adjusted";597;373;105;268;554;446
"3583";"1. Random";"1. Random";598;363;79;284;492;508
"3584";"6. Biased  coin";"6. Biased  coin";598;396;99;297;501;500
"3585";"2. Neyman known";"2. Neyman known";598;420;103;317;470;530
"3586";"3. RSIHR Known";"3. RSIHR Known";598;427;74;353;395;605
"3587";"4. Rosenberger known";"4. Rosenberger known";598;531;19;512;136;864
"3588";"5. Optimal adjusted";"5. Optimal adjusted";598;391;102;289;527;473
"3589";"1. Random";"1. Random";599;401;98;303;503;497
"3590";"6. Biased  coin";"6. Biased  coin";599;422;108;314;499;501
"3591";"2. Neyman known";"2. Neyman known";599;404;86;318;482;518
"3592";"3. RSIHR Known";"3. RSIHR Known";599;453;67;386;369;631
"3593";"4. Rosenberger known";"4. Rosenberger known";599;559;32;527;144;856
"3594";"5. Optimal adjusted";"5. Optimal adjusted";599;399;101;298;539;461
"3595";"1. Random";"1. Random";600;388;85;303;495;505
"3596";"6. Biased  coin";"6. Biased  coin";600;382;91;291;502;499
"3597";"2. Neyman known";"2. Neyman known";600;419;86;333;430;570
"3598";"3. RSIHR Known";"3. RSIHR Known";600;429;65;364;371;629
"3599";"4. Rosenberger known";"4. Rosenberger known";600;529;33;496;157;843
"3600";"5. Optimal adjusted";"5. Optimal adjusted";600;364;91;273;532;468
"3601";"1. Random";"1. Random";601;408;99;309;501;499
"3602";"6. Biased  coin";"6. Biased  coin";601;391;88;303;501;500
"3603";"2. Neyman known";"2. Neyman known";601;423;86;337;446;554
"3604";"3. RSIHR Known";"3. RSIHR Known";601;444;73;371;371;629
"3605";"4. Rosenberger known";"4. Rosenberger known";601;537;26;511;158;842
"3606";"5. Optimal adjusted";"5. Optimal adjusted";601;390;111;279;533;467
"3607";"1. Random";"1. Random";602;416;113;303;504;496
"3608";"6. Biased  coin";"6. Biased  coin";602;430;115;315;501;500
"3609";"2. Neyman known";"2. Neyman known";602;434;93;341;463;537
"3610";"3. RSIHR Known";"3. RSIHR Known";602;462;71;391;362;638
"3611";"4. Rosenberger known";"4. Rosenberger known";602;554;28;526;157;843
"3612";"5. Optimal adjusted";"5. Optimal adjusted";602;401;127;274;551;449
"3613";"1. Random";"1. Random";603;410;90;320;495;505
"3614";"6. Biased  coin";"6. Biased  coin";603;396;93;303;500;500
"3615";"2. Neyman known";"2. Neyman known";603;418;94;324;482;518
"3616";"3. RSIHR Known";"3. RSIHR Known";603;454;62;392;367;633
"3617";"4. Rosenberger known";"4. Rosenberger known";603;545;28;517;146;854
"3618";"5. Optimal adjusted";"5. Optimal adjusted";603;380;94;286;519;481
"3619";"1. Random";"1. Random";604;417;109;308;500;500
"3620";"6. Biased  coin";"6. Biased  coin";604;387;95;292;499;501
"3621";"2. Neyman known";"2. Neyman known";604;416;98;318;447;553
"3622";"3. RSIHR Known";"3. RSIHR Known";604;443;70;373;378;622
"3623";"4. Rosenberger known";"4. Rosenberger known";604;548;33;515;145;855
"3624";"5. Optimal adjusted";"5. Optimal adjusted";604;386;94;292;520;480
"3625";"1. Random";"1. Random";605;395;95;300;509;491
"3626";"6. Biased  coin";"6. Biased  coin";605;399;92;307;500;500
"3627";"2. Neyman known";"2. Neyman known";605;442;90;352;447;553
"3628";"3. RSIHR Known";"3. RSIHR Known";605;456;67;389;366;634
"3629";"4. Rosenberger known";"4. Rosenberger known";605;555;29;526;148;852
"3630";"5. Optimal adjusted";"5. Optimal adjusted";605;372;84;288;538;462
"3631";"1. Random";"1. Random";606;412;112;300;513;487
"3632";"6. Biased  coin";"6. Biased  coin";606;391;95;296;500;500
"3633";"2. Neyman known";"2. Neyman known";606;421;91;330;447;553
"3634";"3. RSIHR Known";"3. RSIHR Known";606;463;68;395;328;672
"3635";"4. Rosenberger known";"4. Rosenberger known";606;556;27;529;141;859
"3636";"5. Optimal adjusted";"5. Optimal adjusted";606;385;117;268;551;449
"3637";"1. Random";"1. Random";607;401;96;305;513;487
"3638";"6. Biased  coin";"6. Biased  coin";607;397;96;301;501;499
"3639";"2. Neyman known";"2. Neyman known";607;440;81;359;442;558
"3640";"3. RSIHR Known";"3. RSIHR Known";607;471;60;411;347;653
"3641";"4. Rosenberger known";"4. Rosenberger known";607;582;25;557;143;857
"3642";"5. Optimal adjusted";"5. Optimal adjusted";607;417;111;306;533;467
"3643";"1. Random";"1. Random";608;441;105;336;473;527
"3644";"6. Biased  coin";"6. Biased  coin";608;428;104;324;503;499
"3645";"2. Neyman known";"2. Neyman known";608;444;107;337;446;554
"3646";"3. RSIHR Known";"3. RSIHR Known";608;480;78;402;363;637
"3647";"4. Rosenberger known";"4. Rosenberger known";608;553;29;524;152;848
"3648";"5. Optimal adjusted";"5. Optimal adjusted";608;390;109;281;544;456
"3649";"1. Random";"1. Random";609;423;104;319;498;502
"3650";"6. Biased  coin";"6. Biased  coin";609;388;85;303;501;500
"3651";"2. Neyman known";"2. Neyman known";609;415;80;335;450;550
"3652";"3. RSIHR Known";"3. RSIHR Known";609;455;69;386;368;632
"3653";"4. Rosenberger known";"4. Rosenberger known";609;558;30;528;124;876
"3654";"5. Optimal adjusted";"5. Optimal adjusted";609;381;95;286;533;467
"3655";"1. Random";"1. Random";610;415;106;309;508;492
"3656";"6. Biased  coin";"6. Biased  coin";610;369;90;279;499;501
"3657";"2. Neyman known";"2. Neyman known";610;413;95;318;454;546
"3658";"3. RSIHR Known";"3. RSIHR Known";610;437;75;362;393;607
"3659";"4. Rosenberger known";"4. Rosenberger known";610;522;22;500;154;846
"3660";"5. Optimal adjusted";"5. Optimal adjusted";610;418;110;308;521;479
"3661";"1. Random";"1. Random";611;392;104;288;499;501
"3662";"6. Biased  coin";"6. Biased  coin";611;396;101;295;501;499
"3663";"2. Neyman known";"2. Neyman known";611;409;77;332;418;582
"3664";"3. RSIHR Known";"3. RSIHR Known";611;446;69;377;354;646
"3665";"4. Rosenberger known";"4. Rosenberger known";611;545;32;513;147;853
"3666";"5. Optimal adjusted";"5. Optimal adjusted";611;402;112;290;527;473
"3667";"1. Random";"1. Random";612;407;87;320;472;528
"3668";"6. Biased  coin";"6. Biased  coin";612;397;96;301;503;498
"3669";"2. Neyman known";"2. Neyman known";612;419;72;347;423;577
"3670";"3. RSIHR Known";"3. RSIHR Known";612;431;68;363;388;612
"3671";"4. Rosenberger known";"4. Rosenberger known";612;551;18;533;131;869
"3672";"5. Optimal adjusted";"5. Optimal adjusted";612;372;93;279;542;458
"3673";"1. Random";"1. Random";613;394;112;282;495;505
"3674";"6. Biased  coin";"6. Biased  coin";613;399;113;286;501;500
"3675";"2. Neyman known";"2. Neyman known";613;401;93;308;463;537
"3676";"3. RSIHR Known";"3. RSIHR Known";613;442;76;366;368;632
"3677";"4. Rosenberger known";"4. Rosenberger known";613;549;29;520;130;870
"3678";"5. Optimal adjusted";"5. Optimal adjusted";613;393;105;288;512;488
"3679";"1. Random";"1. Random";614;415;90;325;487;513
"3680";"6. Biased  coin";"6. Biased  coin";614;394;90;304;500;500
"3681";"2. Neyman known";"2. Neyman known";614;412;96;316;485;515
"3682";"3. RSIHR Known";"3. RSIHR Known";614;445;64;381;369;631
"3683";"4. Rosenberger known";"4. Rosenberger known";614;544;28;516;161;839
"3684";"5. Optimal adjusted";"5. Optimal adjusted";614;391;117;274;551;449
"3685";"1. Random";"1. Random";615;388;98;290;513;487
"3686";"6. Biased  coin";"6. Biased  coin";615;417;96;321;501;501
"3687";"2. Neyman known";"2. Neyman known";615;431;92;339;473;527
"3688";"3. RSIHR Known";"3. RSIHR Known";615;474;79;395;376;624
"3689";"4. Rosenberger known";"4. Rosenberger known";615;571;34;537;149;851
"3690";"5. Optimal adjusted";"5. Optimal adjusted";615;401;116;285;537;463
"3691";"1. Random";"1. Random";616;403;124;279;527;473
"3692";"6. Biased  coin";"6. Biased  coin";616;416;110;306;499;502
"3693";"2. Neyman known";"2. Neyman known";616;424;89;335;444;556
"3694";"3. RSIHR Known";"3. RSIHR Known";616;459;76;383;361;639
"3695";"4. Rosenberger known";"4. Rosenberger known";616;541;35;506;141;859
"3696";"5. Optimal adjusted";"5. Optimal adjusted";616;382;120;262;555;445
"3697";"1. Random";"1. Random";617;383;89;294;501;499
"3698";"6. Biased  coin";"6. Biased  coin";617;406;101;305;502;499
"3699";"2. Neyman known";"2. Neyman known";617;414;85;329;447;553
"3700";"3. RSIHR Known";"3. RSIHR Known";617;452;70;382;377;623
"3701";"4. Rosenberger known";"4. Rosenberger known";617;560;36;524;149;851
"3702";"5. Optimal adjusted";"5. Optimal adjusted";617;405;116;289;525;475
"3703";"1. Random";"1. Random";618;429;103;326;475;525
"3704";"6. Biased  coin";"6. Biased  coin";618;410;107;303;500;500
"3705";"2. Neyman known";"2. Neyman known";618;414;98;316;448;552
"3706";"3. RSIHR Known";"3. RSIHR Known";618;467;81;386;374;626
"3707";"4. Rosenberger known";"4. Rosenberger known";618;551;25;526;137;863
"3708";"5. Optimal adjusted";"5. Optimal adjusted";618;395;109;286;524;476
"3709";"1. Random";"1. Random";619;400;92;308;497;503
"3710";"6. Biased  coin";"6. Biased  coin";619;414;104;310;501;500
"3711";"2. Neyman known";"2. Neyman known";619;426;86;340;450;550
"3712";"3. RSIHR Known";"3. RSIHR Known";619;462;74;388;375;625
"3713";"4. Rosenberger known";"4. Rosenberger known";619;556;27;529;145;855
"3714";"5. Optimal adjusted";"5. Optimal adjusted";619;390;102;288;532;468
"3715";"1. Random";"1. Random";620;406;105;301;500;500
"3716";"6. Biased  coin";"6. Biased  coin";620;403;110;293;501;500
"3717";"2. Neyman known";"2. Neyman known";620;426;93;333;451;549
"3718";"3. RSIHR Known";"3. RSIHR Known";620;426;71;355;367;633
"3719";"4. Rosenberger known";"4. Rosenberger known";620;510;21;489;145;855
"3720";"5. Optimal adjusted";"5. Optimal adjusted";620;403;105;298;510;490
"3721";"1. Random";"1. Random";621;386;94;292;519;481
"3722";"6. Biased  coin";"6. Biased  coin";621;391;91;300;501;499
"3723";"2. Neyman known";"2. Neyman known";621;427;84;343;461;539
"3724";"3. RSIHR Known";"3. RSIHR Known";621;456;57;399;352;648
"3725";"4. Rosenberger known";"4. Rosenberger known";621;533;29;504;151;849
"3726";"5. Optimal adjusted";"5. Optimal adjusted";621;391;105;286;536;464
"3727";"1. Random";"1. Random";622;414;92;322;486;514
"3728";"6. Biased  coin";"6. Biased  coin";622;370;83;287;502;499
"3729";"2. Neyman known";"2. Neyman known";622;419;79;340;446;554
"3730";"3. RSIHR Known";"3. RSIHR Known";622;443;52;391;348;652
"3731";"4. Rosenberger known";"4. Rosenberger known";622;550;24;526;137;863
"3732";"5. Optimal adjusted";"5. Optimal adjusted";622;406;100;306;518;482
"3733";"1. Random";"1. Random";623;424;107;317;492;508
"3734";"6. Biased  coin";"6. Biased  coin";623;404;91;313;499;501
"3735";"2. Neyman known";"2. Neyman known";623;410;82;328;443;557
"3736";"3. RSIHR Known";"3. RSIHR Known";623;473;80;393;375;625
"3737";"4. Rosenberger known";"4. Rosenberger known";623;546;19;527;129;871
"3738";"5. Optimal adjusted";"5. Optimal adjusted";623;366;101;265;550;450
"3739";"1. Random";"1. Random";624;378;87;291;485;515
"3740";"6. Biased  coin";"6. Biased  coin";624;389;93;296;500;500
"3741";"2. Neyman known";"2. Neyman known";624;397;82;315;470;530
"3742";"3. RSIHR Known";"3. RSIHR Known";624;469;68;401;344;656
"3743";"4. Rosenberger known";"4. Rosenberger known";624;535;22;513;132;868
"3744";"5. Optimal adjusted";"5. Optimal adjusted";624;405;103;302;528;472
"3745";"1. Random";"1. Random";625;427;104;323;470;530
"3746";"6. Biased  coin";"6. Biased  coin";625;425;110;315;501;499
"3747";"2. Neyman known";"2. Neyman known";625;427;88;339;445;555
"3748";"3. RSIHR Known";"3. RSIHR Known";625;462;61;401;365;635
"3749";"4. Rosenberger known";"4. Rosenberger known";625;541;15;526;146;854
"3750";"5. Optimal adjusted";"5. Optimal adjusted";625;402;105;297;527;473
"3751";"1. Random";"1. Random";626;418;98;320;488;512
"3752";"6. Biased  coin";"6. Biased  coin";626;435;116;319;501;499
"3753";"2. Neyman known";"2. Neyman known";626;458;104;354;446;554
"3754";"3. RSIHR Known";"3. RSIHR Known";626;493;82;411;363;637
"3755";"4. Rosenberger known";"4. Rosenberger known";626;562;31;531;138;862
"3756";"5. Optimal adjusted";"5. Optimal adjusted";626;401;111;290;531;469
"3757";"1. Random";"1. Random";627;408;88;320;506;494
"3758";"6. Biased  coin";"6. Biased  coin";627;396;94;302;504;500
"3759";"2. Neyman known";"2. Neyman known";627;440;89;351;451;549
"3760";"3. RSIHR Known";"3. RSIHR Known";627;467;65;402;356;644
"3761";"4. Rosenberger known";"4. Rosenberger known";627;551;29;522;144;856
"3762";"5. Optimal adjusted";"5. Optimal adjusted";627;403;107;296;537;463
"3763";"1. Random";"1. Random";628;375;94;281;481;519
"3764";"6. Biased  coin";"6. Biased  coin";628;390;99;291;505;496
"3765";"2. Neyman known";"2. Neyman known";628;380;83;297;457;543
"3766";"3. RSIHR Known";"3. RSIHR Known";628;420;82;338;396;604
"3767";"4. Rosenberger known";"4. Rosenberger known";628;501;22;479;157;843
"3768";"5. Optimal adjusted";"5. Optimal adjusted";628;360;106;254;529;471
"3769";"1. Random";"1. Random";629;388;95;293;507;493
"3770";"6. Biased  coin";"6. Biased  coin";629;419;106;313;501;500
"3771";"2. Neyman known";"2. Neyman known";629;421;90;331;451;549
"3772";"3. RSIHR Known";"3. RSIHR Known";629;465;77;388;372;628
"3773";"4. Rosenberger known";"4. Rosenberger known";629;557;36;521;156;844
"3774";"5. Optimal adjusted";"5. Optimal adjusted";629;380;102;278;543;457
"3775";"1. Random";"1. Random";630;391;98;293;489;511
"3776";"6. Biased  coin";"6. Biased  coin";630;384;98;286;500;500
"3777";"2. Neyman known";"2. Neyman known";630;420;95;325;452;548
"3778";"3. RSIHR Known";"3. RSIHR Known";630;449;78;371;380;620
"3779";"4. Rosenberger known";"4. Rosenberger known";630;543;27;516;132;868
"3780";"5. Optimal adjusted";"5. Optimal adjusted";630;384;106;278;532;468
"3781";"1. Random";"1. Random";631;419;82;337;486;514
"3782";"6. Biased  coin";"6. Biased  coin";631;399;90;309;500;501
"3783";"2. Neyman known";"2. Neyman known";631;436;78;358;444;556
"3784";"3. RSIHR Known";"3. RSIHR Known";631;459;75;384;378;622
"3785";"4. Rosenberger known";"4. Rosenberger known";631;557;30;527;152;848
"3786";"5. Optimal adjusted";"5. Optimal adjusted";631;382;96;286;544;456
"3787";"1. Random";"1. Random";632;397;92;305;481;519
"3788";"6. Biased  coin";"6. Biased  coin";632;394;95;299;501;501
"3789";"2. Neyman known";"2. Neyman known";632;391;91;300;484;516
"3790";"3. RSIHR Known";"3. RSIHR Known";632;449;72;377;359;641
"3791";"4. Rosenberger known";"4. Rosenberger known";632;547;31;516;133;867
"3792";"5. Optimal adjusted";"5. Optimal adjusted";632;371;96;275;532;468
"3793";"1. Random";"1. Random";633;431;105;326;492;508
"3794";"6. Biased  coin";"6. Biased  coin";633;412;107;305;499;501
"3795";"2. Neyman known";"2. Neyman known";633;438;104;334;464;536
"3796";"3. RSIHR Known";"3. RSIHR Known";633;460;72;388;373;627
"3797";"4. Rosenberger known";"4. Rosenberger known";633;576;32;544;151;849
"3798";"5. Optimal adjusted";"5. Optimal adjusted";633;424;114;310;520;480
"3799";"1. Random";"1. Random";634;418;122;296;533;467
"3800";"6. Biased  coin";"6. Biased  coin";634;412;105;307;506;499
"3801";"2. Neyman known";"2. Neyman known";634;418;99;319;458;542
"3802";"3. RSIHR Known";"3. RSIHR Known";634;442;67;375;356;644
"3803";"4. Rosenberger known";"4. Rosenberger known";634;556;29;527;131;869
"3804";"5. Optimal adjusted";"5. Optimal adjusted";634;383;106;277;547;453
"3805";"1. Random";"1. Random";635;409;104;305;501;499
"3806";"6. Biased  coin";"6. Biased  coin";635;391;83;308;500;500
"3807";"2. Neyman known";"2. Neyman known";635;419;93;326;452;548
"3808";"3. RSIHR Known";"3. RSIHR Known";635;436;63;373;371;629
"3809";"4. Rosenberger known";"4. Rosenberger known";635;557;28;529;142;858
"3810";"5. Optimal adjusted";"5. Optimal adjusted";635;388;96;292;502;498
"3811";"1. Random";"1. Random";636;383;95;288;523;477
"3812";"6. Biased  coin";"6. Biased  coin";636;381;89;292;500;501
"3813";"2. Neyman known";"2. Neyman known";636;408;78;330;440;560
"3814";"3. RSIHR Known";"3. RSIHR Known";636;457;72;385;378;622
"3815";"4. Rosenberger known";"4. Rosenberger known";636;536;26;510;133;867
"3816";"5. Optimal adjusted";"5. Optimal adjusted";636;360;97;263;556;444
"3817";"1. Random";"1. Random";637;405;109;296;491;509
"3818";"6. Biased  coin";"6. Biased  coin";637;400;103;297;502;499
"3819";"2. Neyman known";"2. Neyman known";637;417;87;330;457;543
"3820";"3. RSIHR Known";"3. RSIHR Known";637;454;71;383;353;647
"3821";"4. Rosenberger known";"4. Rosenberger known";637;546;34;512;149;851
"3822";"5. Optimal adjusted";"5. Optimal adjusted";637;379;121;258;567;433
"3823";"1. Random";"1. Random";638;404;96;308;468;532
"3824";"6. Biased  coin";"6. Biased  coin";638;399;97;302;504;498
"3825";"2. Neyman known";"2. Neyman known";638;396;73;323;432;568
"3826";"3. RSIHR Known";"3. RSIHR Known";638;447;74;373;374;626
"3827";"4. Rosenberger known";"4. Rosenberger known";638;533;27;506;156;844
"3828";"5. Optimal adjusted";"5. Optimal adjusted";638;399;115;284;525;475
"3829";"1. Random";"1. Random";639;380;93;287;506;494
"3830";"6. Biased  coin";"6. Biased  coin";639;391;97;294;500;501
"3831";"2. Neyman known";"2. Neyman known";639;424;91;333;450;550
"3832";"3. RSIHR Known";"3. RSIHR Known";639;455;84;371;388;612
"3833";"4. Rosenberger known";"4. Rosenberger known";639;544;29;515;155;845
"3834";"5. Optimal adjusted";"5. Optimal adjusted";639;388;109;279;534;466
"3835";"1. Random";"1. Random";640;400;88;312;494;506
"3836";"6. Biased  coin";"6. Biased  coin";640;442;117;325;501;500
"3837";"2. Neyman known";"2. Neyman known";640;442;90;352;459;541
"3838";"3. RSIHR Known";"3. RSIHR Known";640;461;66;395;356;644
"3839";"4. Rosenberger known";"4. Rosenberger known";640;562;28;534;148;852
"3840";"5. Optimal adjusted";"5. Optimal adjusted";640;402;108;294;541;459
"3841";"1. Random";"1. Random";641;405;90;315;499;501
"3842";"6. Biased  coin";"6. Biased  coin";641;406;88;318;502;499
"3843";"2. Neyman known";"2. Neyman known";641;402;84;318;468;532
"3844";"3. RSIHR Known";"3. RSIHR Known";641;471;60;411;340;660
"3845";"4. Rosenberger known";"4. Rosenberger known";641;553;28;525;160;840
"3846";"5. Optimal adjusted";"5. Optimal adjusted";641;394;93;301;518;482
"3847";"1. Random";"1. Random";642;414;119;295;513;487
"3848";"6. Biased  coin";"6. Biased  coin";642;411;101;310;501;499
"3849";"2. Neyman known";"2. Neyman known";642;439;90;349;429;571
"3850";"3. RSIHR Known";"3. RSIHR Known";642;471;79;392;360;640
"3851";"4. Rosenberger known";"4. Rosenberger known";642;566;29;537;123;877
"3852";"5. Optimal adjusted";"5. Optimal adjusted";642;398;97;301;494;506
"3853";"1. Random";"1. Random";643;410;107;303;503;497
"3854";"6. Biased  coin";"6. Biased  coin";643;388;84;304;504;501
"3855";"2. Neyman known";"2. Neyman known";643;419;96;323;465;535
"3856";"3. RSIHR Known";"3. RSIHR Known";643;454;70;384;362;638
"3857";"4. Rosenberger known";"4. Rosenberger known";643;542;29;513;138;862
"3858";"5. Optimal adjusted";"5. Optimal adjusted";643;384;104;280;536;464
"3859";"1. Random";"1. Random";644;404;87;317;485;515
"3860";"6. Biased  coin";"6. Biased  coin";644;390;88;302;500;501
"3861";"2. Neyman known";"2. Neyman known";644;428;79;349;436;564
"3862";"3. RSIHR Known";"3. RSIHR Known";644;445;66;379;377;623
"3863";"4. Rosenberger known";"4. Rosenberger known";644;536;25;511;137;863
"3864";"5. Optimal adjusted";"5. Optimal adjusted";644;370;97;273;525;475
"3865";"1. Random";"1. Random";645;400;97;303;504;496
"3866";"6. Biased  coin";"6. Biased  coin";645;411;101;310;500;501
"3867";"2. Neyman known";"2. Neyman known";645;436;82;354;445;555
"3868";"3. RSIHR Known";"3. RSIHR Known";645;458;86;372;398;602
"3869";"4. Rosenberger known";"4. Rosenberger known";645;551;24;527;130;870
"3870";"5. Optimal adjusted";"5. Optimal adjusted";645;376;99;277;547;453
"3871";"1. Random";"1. Random";646;406;108;298;496;504
"3872";"6. Biased  coin";"6. Biased  coin";646;411;118;293;501;500
"3873";"2. Neyman known";"2. Neyman known";646;400;92;308;464;536
"3874";"3. RSIHR Known";"3. RSIHR Known";646;444;77;367;371;629
"3875";"4. Rosenberger known";"4. Rosenberger known";646;534;37;497;153;847
"3876";"5. Optimal adjusted";"5. Optimal adjusted";646;373;113;260;543;457
"3877";"1. Random";"1. Random";647;406;94;312;469;531
"3878";"6. Biased  coin";"6. Biased  coin";647;406;100;306;499;502
"3879";"2. Neyman known";"2. Neyman known";647;409;85;324;452;548
"3880";"3. RSIHR Known";"3. RSIHR Known";647;466;79;387;349;651
"3881";"4. Rosenberger known";"4. Rosenberger known";647;533;28;505;138;862
"3882";"5. Optimal adjusted";"5. Optimal adjusted";647;386;100;286;492;508
"3883";"1. Random";"1. Random";648;418;103;315;500;500
"3884";"6. Biased  coin";"6. Biased  coin";648;400;101;299;501;499
"3885";"2. Neyman known";"2. Neyman known";648;439;93;346;453;547
"3886";"3. RSIHR Known";"3. RSIHR Known";648;458;65;393;374;626
"3887";"4. Rosenberger known";"4. Rosenberger known";648;560;35;525;148;852
"3888";"5. Optimal adjusted";"5. Optimal adjusted";648;385;99;286;516;484
"3889";"1. Random";"1. Random";649;420;103;317;498;502
"3890";"6. Biased  coin";"6. Biased  coin";649;388;89;299;500;500
"3891";"2. Neyman known";"2. Neyman known";649;432;91;341;447;553
"3892";"3. RSIHR Known";"3. RSIHR Known";649;462;77;385;368;632
"3893";"4. Rosenberger known";"4. Rosenberger known";649;567;22;545;125;875
"3894";"5. Optimal adjusted";"5. Optimal adjusted";649;420;100;320;498;502
"3895";"1. Random";"1. Random";650;386;95;291;523;477
"3896";"6. Biased  coin";"6. Biased  coin";650;396;99;297;502;498
"3897";"2. Neyman known";"2. Neyman known";650;426;92;334;441;559
"3898";"3. RSIHR Known";"3. RSIHR Known";650;449;63;386;364;636
"3899";"4. Rosenberger known";"4. Rosenberger known";650;542;30;512;143;857
"3900";"5. Optimal adjusted";"5. Optimal adjusted";650;391;110;281;541;459
"3901";"1. Random";"1. Random";651;385;93;292;509;491
"3902";"6. Biased  coin";"6. Biased  coin";651;377;91;286;501;499
"3903";"2. Neyman known";"2. Neyman known";651;415;83;332;424;576
"3904";"3. RSIHR Known";"3. RSIHR Known";651;458;82;376;373;627
"3905";"4. Rosenberger known";"4. Rosenberger known";651;529;29;500;157;843
"3906";"5. Optimal adjusted";"5. Optimal adjusted";651;389;97;292;513;487
"3907";"1. Random";"1. Random";652;420;88;332;457;543
"3908";"6. Biased  coin";"6. Biased  coin";652;413;104;309;503;500
"3909";"2. Neyman known";"2. Neyman known";652;439;96;343;447;553
"3910";"3. RSIHR Known";"3. RSIHR Known";652;467;69;398;356;644
"3911";"4. Rosenberger known";"4. Rosenberger known";652;555;36;519;149;851
"3912";"5. Optimal adjusted";"5. Optimal adjusted";652;391;102;289;539;461
"3913";"1. Random";"1. Random";653;376;99;277;508;492
"3914";"6. Biased  coin";"6. Biased  coin";653;401;106;295;501;502
"3915";"2. Neyman known";"2. Neyman known";653;419;93;326;439;561
"3916";"3. RSIHR Known";"3. RSIHR Known";653;429;68;361;395;605
"3917";"4. Rosenberger known";"4. Rosenberger known";653;525;32;493;153;847
"3918";"5. Optimal adjusted";"5. Optimal adjusted";653;371;114;257;552;448
"3919";"1. Random";"1. Random";654;379;90;289;510;490
"3920";"6. Biased  coin";"6. Biased  coin";654;369;82;287;505;500
"3921";"2. Neyman known";"2. Neyman known";654;406;57;349;423;577
"3922";"3. RSIHR Known";"3. RSIHR Known";654;419;55;364;365;635
"3923";"4. Rosenberger known";"4. Rosenberger known";654;523;20;503;125;875
"3924";"5. Optimal adjusted";"5. Optimal adjusted";654;337;85;252;548;452
"3925";"1. Random";"1. Random";655;401;97;304;503;497
"3926";"6. Biased  coin";"6. Biased  coin";655;407;101;306;502;499
"3927";"2. Neyman known";"2. Neyman known";655;436;95;341;454;546
"3928";"3. RSIHR Known";"3. RSIHR Known";655;458;72;386;381;619
"3929";"4. Rosenberger known";"4. Rosenberger known";655;554;30;524;143;857
"3930";"5. Optimal adjusted";"5. Optimal adjusted";655;392;117;275;550;450
"3931";"1. Random";"1. Random";656;402;98;304;493;507
"3932";"6. Biased  coin";"6. Biased  coin";656;419;115;304;499;501
"3933";"2. Neyman known";"2. Neyman known";656;419;96;323;474;526
"3934";"3. RSIHR Known";"3. RSIHR Known";656;456;67;389;345;655
"3935";"4. Rosenberger known";"4. Rosenberger known";656;546;32;514;150;850
"3936";"5. Optimal adjusted";"5. Optimal adjusted";656;399;99;300;513;487
"3937";"1. Random";"1. Random";657;407;94;313;492;508
"3938";"6. Biased  coin";"6. Biased  coin";657;393;100;293;499;501
"3939";"2. Neyman known";"2. Neyman known";657;401;80;321;452;548
"3940";"3. RSIHR Known";"3. RSIHR Known";657;449;60;389;359;641
"3941";"4. Rosenberger known";"4. Rosenberger known";657;528;26;502;146;854
"3942";"5. Optimal adjusted";"5. Optimal adjusted";657;379;104;275;535;465
"3943";"1. Random";"1. Random";658;371;105;266;517;483
"3944";"6. Biased  coin";"6. Biased  coin";658;394;101;293;500;500
"3945";"2. Neyman known";"2. Neyman known";658;417;95;322;456;544
"3946";"3. RSIHR Known";"3. RSIHR Known";658;446;74;372;363;637
"3947";"4. Rosenberger known";"4. Rosenberger known";658;528;30;498;129;871
"3948";"5. Optimal adjusted";"5. Optimal adjusted";658;377;113;264;542;458
"3949";"1. Random";"1. Random";659;382;99;283;514;486
"3950";"6. Biased  coin";"6. Biased  coin";659;390;97;293;501;499
"3951";"2. Neyman known";"2. Neyman known";659;406;79;327;458;542
"3952";"3. RSIHR Known";"3. RSIHR Known";659;429;75;354;407;593
"3953";"4. Rosenberger known";"4. Rosenberger known";659;534;31;503;148;852
"3954";"5. Optimal adjusted";"5. Optimal adjusted";659;387;101;286;521;479
"3955";"1. Random";"1. Random";660;378;79;299;504;496
"3956";"6. Biased  coin";"6. Biased  coin";660;379;89;290;502;500
"3957";"2. Neyman known";"2. Neyman known";660;392;69;323;455;545
"3958";"3. RSIHR Known";"3. RSIHR Known";660;422;52;370;359;641
"3959";"4. Rosenberger known";"4. Rosenberger known";660;529;22;507;156;844
"3960";"5. Optimal adjusted";"5. Optimal adjusted";660;407;96;311;521;479
"3961";"1. Random";"1. Random";661;390;105;285;513;487
"3962";"6. Biased  coin";"6. Biased  coin";661;380;90;290;502;498
"3963";"2. Neyman known";"2. Neyman known";661;394;81;313;453;547
"3964";"3. RSIHR Known";"3. RSIHR Known";661;429;63;366;382;618
"3965";"4. Rosenberger known";"4. Rosenberger known";661;528;27;501;136;864
"3966";"5. Optimal adjusted";"5. Optimal adjusted";661;384;104;280;537;463
"3967";"1. Random";"1. Random";662;388;97;291;508;492
"3968";"6. Biased  coin";"6. Biased  coin";662;402;100;302;499;501
"3969";"2. Neyman known";"2. Neyman known";662;440;91;349;445;555
"3970";"3. RSIHR Known";"3. RSIHR Known";662;491;80;411;336;664
"3971";"4. Rosenberger known";"4. Rosenberger known";662;555;32;523;154;846
"3972";"5. Optimal adjusted";"5. Optimal adjusted";662;391;96;295;511;489
"3973";"1. Random";"1. Random";663;418;121;297;528;472
"3974";"6. Biased  coin";"6. Biased  coin";663;404;106;298;501;500
"3975";"2. Neyman known";"2. Neyman known";663;429;105;324;461;539
"3976";"3. RSIHR Known";"3. RSIHR Known";663;453;68;385;380;620
"3977";"4. Rosenberger known";"4. Rosenberger known";663;553;34;519;152;848
"3978";"5. Optimal adjusted";"5. Optimal adjusted";663;396;106;290;538;462
"3979";"1. Random";"1. Random";664;408;94;314;507;493
"3980";"6. Biased  coin";"6. Biased  coin";664;411;99;312;502;500
"3981";"2. Neyman known";"2. Neyman known";664;466;85;381;426;574
"3982";"3. RSIHR Known";"3. RSIHR Known";664;464;63;401;359;641
"3983";"4. Rosenberger known";"4. Rosenberger known";664;563;25;538;152;848
"3984";"5. Optimal adjusted";"5. Optimal adjusted";664;389;99;290;529;471
"3985";"1. Random";"1. Random";665;422;107;315;488;512
"3986";"6. Biased  coin";"6. Biased  coin";665;413;111;302;500;500
"3987";"2. Neyman known";"2. Neyman known";665;446;109;337;441;559
"3988";"3. RSIHR Known";"3. RSIHR Known";665;460;90;370;383;617
"3989";"4. Rosenberger known";"4. Rosenberger known";665;551;31;520;148;852
"3990";"5. Optimal adjusted";"5. Optimal adjusted";665;390;115;275;530;470
"3991";"1. Random";"1. Random";666;428;115;313;490;510
"3992";"6. Biased  coin";"6. Biased  coin";666;408;111;297;502;499
"3993";"2. Neyman known";"2. Neyman known";666;431;94;337;448;552
"3994";"3. RSIHR Known";"3. RSIHR Known";666;456;70;386;368;632
"3995";"4. Rosenberger known";"4. Rosenberger known";666;536;21;515;134;866
"3996";"5. Optimal adjusted";"5. Optimal adjusted";666;403;124;279;544;456
"3997";"1. Random";"1. Random";667;403;92;311;485;515
"3998";"6. Biased  coin";"6. Biased  coin";667;382;100;282;503;498
"3999";"2. Neyman known";"2. Neyman known";667;414;81;333;419;581
"4000";"3. RSIHR Known";"3. RSIHR Known";667;466;71;395;328;672
"4001";"4. Rosenberger known";"4. Rosenberger known";667;549;28;521;149;851
"4002";"5. Optimal adjusted";"5. Optimal adjusted";667;356;106;250;552;448
"4003";"1. Random";"1. Random";668;395;91;304;496;504
"4004";"6. Biased  coin";"6. Biased  coin";668;391;94;297;502;499
"4005";"2. Neyman known";"2. Neyman known";668;419;81;338;449;551
"4006";"3. RSIHR Known";"3. RSIHR Known";668;462;67;395;357;643
"4007";"4. Rosenberger known";"4. Rosenberger known";668;547;30;517;157;843
"4008";"5. Optimal adjusted";"5. Optimal adjusted";668;396;99;297;525;475
"4009";"1. Random";"1. Random";669;454;100;354;468;532
"4010";"6. Biased  coin";"6. Biased  coin";669;408;95;313;500;500
"4011";"2. Neyman known";"2. Neyman known";669;435;95;340;475;525
"4012";"3. RSIHR Known";"3. RSIHR Known";669;474;70;404;365;635
"4013";"4. Rosenberger known";"4. Rosenberger known";669;544;26;518;178;822
"4014";"5. Optimal adjusted";"5. Optimal adjusted";669;391;101;290;525;475
"4015";"1. Random";"1. Random";670;400;99;301;504;496
"4016";"6. Biased  coin";"6. Biased  coin";670;393;90;303;497;503
"4017";"2. Neyman known";"2. Neyman known";670;421;76;345;441;559
"4018";"3. RSIHR Known";"3. RSIHR Known";670;479;64;415;338;662
"4019";"4. Rosenberger known";"4. Rosenberger known";670;564;38;526;159;841
"4020";"5. Optimal adjusted";"5. Optimal adjusted";670;402;111;291;537;463
"4021";"1. Random";"1. Random";671;391;87;304;487;513
"4022";"6. Biased  coin";"6. Biased  coin";671;393;95;298;501;500
"4023";"2. Neyman known";"2. Neyman known";671;400;86;314;488;512
"4024";"3. RSIHR Known";"3. RSIHR Known";671;463;74;389;369;631
"4025";"4. Rosenberger known";"4. Rosenberger known";671;542;32;510;139;861
"4026";"5. Optimal adjusted";"5. Optimal adjusted";671;371;112;259;553;447
"4027";"1. Random";"1. Random";672;428;86;342;472;528
"4028";"6. Biased  coin";"6. Biased  coin";672;419;87;332;501;500
"4029";"2. Neyman known";"2. Neyman known";672;423;81;342;442;558
"4030";"3. RSIHR Known";"3. RSIHR Known";672;476;65;411;367;633
"4031";"4. Rosenberger known";"4. Rosenberger known";672;575;31;544;141;859
"4032";"5. Optimal adjusted";"5. Optimal adjusted";672;377;103;274;575;425
"4033";"1. Random";"1. Random";673;409;115;294;512;488
"4034";"6. Biased  coin";"6. Biased  coin";673;420;109;311;501;500
"4035";"2. Neyman known";"2. Neyman known";673;432;107;325;458;542
"4036";"3. RSIHR Known";"3. RSIHR Known";673;444;80;364;387;613
"4037";"4. Rosenberger known";"4. Rosenberger known";673;553;35;518;146;854
"4038";"5. Optimal adjusted";"5. Optimal adjusted";673;380;112;268;562;438
"4039";"1. Random";"1. Random";674;388;87;301;486;514
"4040";"6. Biased  coin";"6. Biased  coin";674;378;80;298;502;498
"4041";"2. Neyman known";"2. Neyman known";674;418;77;341;457;543
"4042";"3. RSIHR Known";"3. RSIHR Known";674;463;59;404;341;659
"4043";"4. Rosenberger known";"4. Rosenberger known";674;549;27;522;137;863
"4044";"5. Optimal adjusted";"5. Optimal adjusted";674;376;93;283;509;491
"4045";"1. Random";"1. Random";675;437;100;337;481;519
"4046";"6. Biased  coin";"6. Biased  coin";675;401;98;303;500;501
"4047";"2. Neyman known";"2. Neyman known";675;419;92;327;466;534
"4048";"3. RSIHR Known";"3. RSIHR Known";675;477;75;402;345;655
"4049";"4. Rosenberger known";"4. Rosenberger known";675;557;24;533;146;854
"4050";"5. Optimal adjusted";"5. Optimal adjusted";675;399;104;295;517;483
"4051";"1. Random";"1. Random";676;385;97;288;511;489
"4052";"6. Biased  coin";"6. Biased  coin";676;416;106;310;501;499
"4053";"2. Neyman known";"2. Neyman known";676;419;79;340;453;547
"4054";"3. RSIHR Known";"3. RSIHR Known";676;464;69;395;358;642
"4055";"4. Rosenberger known";"4. Rosenberger known";676;540;27;513;160;840
"4056";"5. Optimal adjusted";"5. Optimal adjusted";676;383;107;276;544;456
"4057";"1. Random";"1. Random";677;405;100;305;502;498
"4058";"6. Biased  coin";"6. Biased  coin";677;414;103;311;497;504
"4059";"2. Neyman known";"2. Neyman known";677;450;98;352;441;559
"4060";"3. RSIHR Known";"3. RSIHR Known";677;476;71;405;346;654
"4061";"4. Rosenberger known";"4. Rosenberger known";677;547;29;518;144;856
"4062";"5. Optimal adjusted";"5. Optimal adjusted";677;381;112;269;554;446
"4063";"1. Random";"1. Random";678;410;89;321;487;513
"4064";"6. Biased  coin";"6. Biased  coin";678;409;92;317;500;500
"4065";"2. Neyman known";"2. Neyman known";678;423;84;339;449;551
"4066";"3. RSIHR Known";"3. RSIHR Known";678;475;56;419;339;661
"4067";"4. Rosenberger known";"4. Rosenberger known";678;557;22;535;139;861
"4068";"5. Optimal adjusted";"5. Optimal adjusted";678;406;94;312;513;487
"4069";"1. Random";"1. Random";679;403;88;315;488;512
"4070";"6. Biased  coin";"6. Biased  coin";679;397;89;308;504;497
"4071";"2. Neyman known";"2. Neyman known";679;430;87;343;443;557
"4072";"3. RSIHR Known";"3. RSIHR Known";679;448;68;380;393;607
"4073";"4. Rosenberger known";"4. Rosenberger known";679;558;24;534;136;864
"4074";"5. Optimal adjusted";"5. Optimal adjusted";679;374;100;274;551;449
"4075";"1. Random";"1. Random";680;400;89;311;491;509
"4076";"6. Biased  coin";"6. Biased  coin";680;409;104;305;501;499
"4077";"2. Neyman known";"2. Neyman known";680;423;91;332;458;542
"4078";"3. RSIHR Known";"3. RSIHR Known";680;431;69;362;388;612
"4079";"4. Rosenberger known";"4. Rosenberger known";680;537;25;512;141;859
"4080";"5. Optimal adjusted";"5. Optimal adjusted";680;367;105;262;554;446
"4081";"1. Random";"1. Random";681;414;112;302;502;498
"4082";"6. Biased  coin";"6. Biased  coin";681;407;106;301;500;500
"4083";"2. Neyman known";"2. Neyman known";681;448;107;341;446;554
"4084";"3. RSIHR Known";"3. RSIHR Known";681;463;90;373;376;624
"4085";"4. Rosenberger known";"4. Rosenberger known";681;543;34;509;151;849
"4086";"5. Optimal adjusted";"5. Optimal adjusted";681;395;113;282;543;457
"4087";"1. Random";"1. Random";682;401;98;303;523;477
"4088";"6. Biased  coin";"6. Biased  coin";682;397;93;304;502;499
"4089";"2. Neyman known";"2. Neyman known";682;439;98;341;449;551
"4090";"3. RSIHR Known";"3. RSIHR Known";682;491;69;422;309;691
"4091";"4. Rosenberger known";"4. Rosenberger known";682;546;25;521;148;852
"4092";"5. Optimal adjusted";"5. Optimal adjusted";682;401;104;297;525;475
"4093";"1. Random";"1. Random";683;392;100;292;498;502
"4094";"6. Biased  coin";"6. Biased  coin";683;380;98;282;501;500
"4095";"2. Neyman known";"2. Neyman known";683;439;99;340;428;572
"4096";"3. RSIHR Known";"3. RSIHR Known";683;473;78;395;354;646
"4097";"4. Rosenberger known";"4. Rosenberger known";683;539;23;516;139;861
"4098";"5. Optimal adjusted";"5. Optimal adjusted";683;388;124;264;566;434
"4099";"1. Random";"1. Random";684;440;109;331;488;512
"4100";"6. Biased  coin";"6. Biased  coin";684;416;112;304;500;500
"4101";"2. Neyman known";"2. Neyman known";684;442;94;348;455;545
"4102";"3. RSIHR Known";"3. RSIHR Known";684;462;71;391;366;634
"4103";"4. Rosenberger known";"4. Rosenberger known";684;554;34;520;146;854
"4104";"5. Optimal adjusted";"5. Optimal adjusted";684;397;114;283;558;442
"4105";"1. Random";"1. Random";685;415;119;296;513;487
"4106";"6. Biased  coin";"6. Biased  coin";685;425;121;304;502;498
"4107";"2. Neyman known";"2. Neyman known";685;426;102;324;448;552
"4108";"3. RSIHR Known";"3. RSIHR Known";685;460;73;387;336;664
"4109";"4. Rosenberger known";"4. Rosenberger known";685;552;23;529;128;872
"4110";"5. Optimal adjusted";"5. Optimal adjusted";685;404;138;266;559;441
"4111";"1. Random";"1. Random";686;399;93;306;491;509
"4112";"6. Biased  coin";"6. Biased  coin";686;404;93;311;500;501
"4113";"2. Neyman known";"2. Neyman known";686;439;97;342;464;536
"4114";"3. RSIHR Known";"3. RSIHR Known";686;432;72;360;400;600
"4115";"4. Rosenberger known";"4. Rosenberger known";686;538;20;518;134;866
"4116";"5. Optimal adjusted";"5. Optimal adjusted";686;380;108;272;538;462
"4117";"1. Random";"1. Random";687;412;101;311;482;518
"4118";"6. Biased  coin";"6. Biased  coin";687;411;102;309;500;500
"4119";"2. Neyman known";"2. Neyman known";687;441;97;344;451;549
"4120";"3. RSIHR Known";"3. RSIHR Known";687;476;70;406;360;640
"4121";"4. Rosenberger known";"4. Rosenberger known";687;559;27;532;139;861
"4122";"5. Optimal adjusted";"5. Optimal adjusted";687;400;104;296;511;489
"4123";"1. Random";"1. Random";688;419;111;308;481;519
"4124";"6. Biased  coin";"6. Biased  coin";688;398;100;298;502;499
"4125";"2. Neyman known";"2. Neyman known";688;436;93;343;421;579
"4126";"3. RSIHR Known";"3. RSIHR Known";688;432;67;365;387;613
"4127";"4. Rosenberger known";"4. Rosenberger known";688;535;23;512;141;859
"4128";"5. Optimal adjusted";"5. Optimal adjusted";688;384;124;260;555;445
"4129";"1. Random";"1. Random";689;389;100;289;506;494
"4130";"6. Biased  coin";"6. Biased  coin";689;379;98;281;502;499
"4131";"2. Neyman known";"2. Neyman known";689;419;90;329;446;554
"4132";"3. RSIHR Known";"3. RSIHR Known";689;437;74;363;369;631
"4133";"4. Rosenberger known";"4. Rosenberger known";689;517;27;490;149;851
"4134";"5. Optimal adjusted";"5. Optimal adjusted";689;368;99;269;520;480
"4135";"1. Random";"1. Random";690;386;99;287;502;498
"4136";"6. Biased  coin";"6. Biased  coin";690;411;106;305;500;501
"4137";"2. Neyman known";"2. Neyman known";690;436;85;351;424;576
"4138";"3. RSIHR Known";"3. RSIHR Known";690;433;73;360;380;620
"4139";"4. Rosenberger known";"4. Rosenberger known";690;538;25;513;146;854
"4140";"5. Optimal adjusted";"5. Optimal adjusted";690;395;107;288;525;475
"4141";"1. Random";"1. Random";691;410;93;317;486;514
"4142";"6. Biased  coin";"6. Biased  coin";691;411;109;302;502;501
"4143";"2. Neyman known";"2. Neyman known";691;431;91;340;439;561
"4144";"3. RSIHR Known";"3. RSIHR Known";691;451;69;382;368;632
"4145";"4. Rosenberger known";"4. Rosenberger known";691;537;41;496;165;835
"4146";"5. Optimal adjusted";"5. Optimal adjusted";691;377;102;275;540;460
"4147";"1. Random";"1. Random";692;395;106;289;512;488
"4148";"6. Biased  coin";"6. Biased  coin";692;423;110;313;503;499
"4149";"2. Neyman known";"2. Neyman known";692;434;94;340;465;535
"4150";"3. RSIHR Known";"3. RSIHR Known";692;450;72;378;382;618
"4151";"4. Rosenberger known";"4. Rosenberger known";692;555;19;536;137;863
"4152";"5. Optimal adjusted";"5. Optimal adjusted";692;383;109;274;529;471
"4153";"1. Random";"1. Random";693;404;85;319;484;516
"4154";"6. Biased  coin";"6. Biased  coin";693;395;100;295;503;498
"4155";"2. Neyman known";"2. Neyman known";693;404;91;313;472;528
"4156";"3. RSIHR Known";"3. RSIHR Known";693;457;71;386;360;640
"4157";"4. Rosenberger known";"4. Rosenberger known";693;528;30;498;165;835
"4158";"5. Optimal adjusted";"5. Optimal adjusted";693;382;92;290;528;472
"4159";"1. Random";"1. Random";694;405;100;305;498;502
"4160";"6. Biased  coin";"6. Biased  coin";694;411;103;308;501;500
"4161";"2. Neyman known";"2. Neyman known";694;414;96;318;466;534
"4162";"3. RSIHR Known";"3. RSIHR Known";694;458;77;381;377;623
"4163";"4. Rosenberger known";"4. Rosenberger known";694;539;30;509;144;856
"4164";"5. Optimal adjusted";"5. Optimal adjusted";694;393;109;284;530;470
"4165";"1. Random";"1. Random";695;385;94;291;487;513
"4166";"6. Biased  coin";"6. Biased  coin";695;388;92;296;500;501
"4167";"2. Neyman known";"2. Neyman known";695;400;85;315;462;538
"4168";"3. RSIHR Known";"3. RSIHR Known";695;447;85;362;388;612
"4169";"4. Rosenberger known";"4. Rosenberger known";695;548;32;516;132;868
"4170";"5. Optimal adjusted";"5. Optimal adjusted";695;396;101;295;516;484
"4171";"1. Random";"1. Random";696;399;103;296;530;470
"4172";"6. Biased  coin";"6. Biased  coin";696;420;104;316;503;498
"4173";"2. Neyman known";"2. Neyman known";696;428;81;347;448;552
"4174";"3. RSIHR Known";"3. RSIHR Known";696;458;72;386;380;620
"4175";"4. Rosenberger known";"4. Rosenberger known";696;569;28;541;139;861
"4176";"5. Optimal adjusted";"5. Optimal adjusted";696;401;112;289;544;456
"4177";"1. Random";"1. Random";697;390;91;299;493;507
"4178";"6. Biased  coin";"6. Biased  coin";697;396;91;305;500;500
"4179";"2. Neyman known";"2. Neyman known";697;436;78;358;442;558
"4180";"3. RSIHR Known";"3. RSIHR Known";697;454;73;381;365;635
"4181";"4. Rosenberger known";"4. Rosenberger known";697;549;25;524;133;867
"4182";"5. Optimal adjusted";"5. Optimal adjusted";697;356;107;249;561;439
"4183";"1. Random";"1. Random";698;385;96;289;496;504
"4184";"6. Biased  coin";"6. Biased  coin";698;395;93;302;500;501
"4185";"2. Neyman known";"2. Neyman known";698;421;96;325;445;555
"4186";"3. RSIHR Known";"3. RSIHR Known";698;453;72;381;364;636
"4187";"4. Rosenberger known";"4. Rosenberger known";698;530;19;511;130;870
"4188";"5. Optimal adjusted";"5. Optimal adjusted";698;404;122;282;524;476
"4189";"1. Random";"1. Random";699;397;94;303;495;505
"4190";"6. Biased  coin";"6. Biased  coin";699;399;101;298;501;500
"4191";"2. Neyman known";"2. Neyman known";699;438;97;341;473;527
"4192";"3. RSIHR Known";"3. RSIHR Known";699;463;84;379;377;623
"4193";"4. Rosenberger known";"4. Rosenberger known";699;554;26;528;133;867
"4194";"5. Optimal adjusted";"5. Optimal adjusted";699;382;103;279;545;455
"4195";"1. Random";"1. Random";700;422;102;320;488;512
"4196";"6. Biased  coin";"6. Biased  coin";700;407;105;302;500;500
"4197";"2. Neyman known";"2. Neyman known";700;448;101;347;447;553
"4198";"3. RSIHR Known";"3. RSIHR Known";700;476;81;395;369;631
"4199";"4. Rosenberger known";"4. Rosenberger known";700;537;24;513;143;857
"4200";"5. Optimal adjusted";"5. Optimal adjusted";700;417;123;294;526;474
"4201";"1. Random";"1. Random";701;384;95;289;515;485
"4202";"6. Biased  coin";"6. Biased  coin";701;417;97;320;501;500
"4203";"2. Neyman known";"2. Neyman known";701;430;86;344;440;560
"4204";"3. RSIHR Known";"3. RSIHR Known";701;470;63;407;366;634
"4205";"4. Rosenberger known";"4. Rosenberger known";701;557;27;530;130;870
"4206";"5. Optimal adjusted";"5. Optimal adjusted";701;384;101;283;536;464
"4207";"1. Random";"1. Random";702;397;88;309;487;513
"4208";"6. Biased  coin";"6. Biased  coin";702;392;98;294;504;499
"4209";"2. Neyman known";"2. Neyman known";702;418;78;340;436;564
"4210";"3. RSIHR Known";"3. RSIHR Known";702;453;81;372;378;622
"4211";"4. Rosenberger known";"4. Rosenberger known";702;551;27;524;142;858
"4212";"5. Optimal adjusted";"5. Optimal adjusted";702;374;112;262;544;456
"4213";"1. Random";"1. Random";703;391;90;301;488;512
"4214";"6. Biased  coin";"6. Biased  coin";703;416;96;320;499;501
"4215";"2. Neyman known";"2. Neyman known";703;428;85;343;461;539
"4216";"3. RSIHR Known";"3. RSIHR Known";703;482;66;416;349;651
"4217";"4. Rosenberger known";"4. Rosenberger known";703;571;29;542;135;865
"4218";"5. Optimal adjusted";"5. Optimal adjusted";703;397;113;284;545;455
"4219";"1. Random";"1. Random";704;386;99;287;511;489
"4220";"6. Biased  coin";"6. Biased  coin";704;418;110;308;501;500
"4221";"2. Neyman known";"2. Neyman known";704;428;91;337;445;555
"4222";"3. RSIHR Known";"3. RSIHR Known";704;435;66;369;371;629
"4223";"4. Rosenberger known";"4. Rosenberger known";704;546;31;515;151;849
"4224";"5. Optimal adjusted";"5. Optimal adjusted";704;388;112;276;546;454
"4225";"1. Random";"1. Random";705;391;93;298;500;500
"4226";"6. Biased  coin";"6. Biased  coin";705;390;95;295;501;500
"4227";"2. Neyman known";"2. Neyman known";705;427;85;342;442;558
"4228";"3. RSIHR Known";"3. RSIHR Known";705;478;69;409;344;656
"4229";"4. Rosenberger known";"4. Rosenberger known";705;556;31;525;145;855
"4230";"5. Optimal adjusted";"5. Optimal adjusted";705;398;104;294;520;480
"4231";"1. Random";"1. Random";706;396;95;301;488;512
"4232";"6. Biased  coin";"6. Biased  coin";706;394;98;296;502;500
"4233";"2. Neyman known";"2. Neyman known";706;423;85;338;454;546
"4234";"3. RSIHR Known";"3. RSIHR Known";706;443;59;384;351;649
"4235";"4. Rosenberger known";"4. Rosenberger known";706;547;27;520;125;875
"4236";"5. Optimal adjusted";"5. Optimal adjusted";706;360;96;264;540;460
"4237";"1. Random";"1. Random";707;432;100;332;484;516
"4238";"6. Biased  coin";"6. Biased  coin";707;396;91;305;500;500
"4239";"2. Neyman known";"2. Neyman known";707;406;85;321;465;535
"4240";"3. RSIHR Known";"3. RSIHR Known";707;459;80;379;390;610
"4241";"4. Rosenberger known";"4. Rosenberger known";707;557;34;523;150;850
"4242";"5. Optimal adjusted";"5. Optimal adjusted";707;387;100;287;525;475
"4243";"1. Random";"1. Random";708;378;93;285;495;505
"4244";"6. Biased  coin";"6. Biased  coin";708;383;97;286;505;496
"4245";"2. Neyman known";"2. Neyman known";708;420;77;343;430;570
"4246";"3. RSIHR Known";"3. RSIHR Known";708;445;76;369;382;618
"4247";"4. Rosenberger known";"4. Rosenberger known";708;536;25;511;141;859
"4248";"5. Optimal adjusted";"5. Optimal adjusted";708;382;108;274;549;451
"4249";"1. Random";"1. Random";709;374;85;289;520;480
"4250";"6. Biased  coin";"6. Biased  coin";709;392;84;308;501;499
"4251";"2. Neyman known";"2. Neyman known";709;404;84;320;451;549
"4252";"3. RSIHR Known";"3. RSIHR Known";709;443;68;375;371;629
"4253";"4. Rosenberger known";"4. Rosenberger known";709;545;28;517;139;861
"4254";"5. Optimal adjusted";"5. Optimal adjusted";709;390;97;293;532;468
"4255";"1. Random";"1. Random";710;406;110;296;526;474
"4256";"6. Biased  coin";"6. Biased  coin";710;410;94;316;500;501
"4257";"2. Neyman known";"2. Neyman known";710;426;92;334;458;542
"4258";"3. RSIHR Known";"3. RSIHR Known";710;452;74;378;368;632
"4259";"4. Rosenberger known";"4. Rosenberger known";710;552;20;532;120;880
"4260";"5. Optimal adjusted";"5. Optimal adjusted";710;390;111;279;540;460
"4261";"1. Random";"1. Random";711;397;99;298;487;513
"4262";"6. Biased  coin";"6. Biased  coin";711;380;91;289;501;500
"4263";"2. Neyman known";"2. Neyman known";711;404;65;339;428;572
"4264";"3. RSIHR Known";"3. RSIHR Known";711;451;59;392;329;671
"4265";"4. Rosenberger known";"4. Rosenberger known";711;522;29;493;160;840
"4266";"5. Optimal adjusted";"5. Optimal adjusted";711;372;87;285;519;481
"4267";"1. Random";"1. Random";712;422;104;318;474;526
"4268";"6. Biased  coin";"6. Biased  coin";712;398;99;299;501;500
"4269";"2. Neyman known";"2. Neyman known";712;416;100;316;462;538
"4270";"3. RSIHR Known";"3. RSIHR Known";712;468;88;380;371;629
"4271";"4. Rosenberger known";"4. Rosenberger known";712;543;19;524;141;859
"4272";"5. Optimal adjusted";"5. Optimal adjusted";712;399;110;289;523;477
"4273";"1. Random";"1. Random";713;416;109;307;499;501
"4274";"6. Biased  coin";"6. Biased  coin";713;403;110;293;500;500
"4275";"2. Neyman known";"2. Neyman known";713;422;103;319;465;535
"4276";"3. RSIHR Known";"3. RSIHR Known";713;461;82;379;366;634
"4277";"4. Rosenberger known";"4. Rosenberger known";713;537;31;506;131;869
"4278";"5. Optimal adjusted";"5. Optimal adjusted";713;398;125;273;533;467
"4279";"1. Random";"1. Random";714;390;100;290;507;493
"4280";"6. Biased  coin";"6. Biased  coin";714;405;97;308;502;499
"4281";"2. Neyman known";"2. Neyman known";714;396;89;307;460;540
"4282";"3. RSIHR Known";"3. RSIHR Known";714;435;66;369;355;645
"4283";"4. Rosenberger known";"4. Rosenberger known";714;550;27;523;140;860
"4284";"5. Optimal adjusted";"5. Optimal adjusted";714;381;112;269;552;448
"4285";"1. Random";"1. Random";715;416;114;302;508;492
"4286";"6. Biased  coin";"6. Biased  coin";715;394;88;306;500;501
"4287";"2. Neyman known";"2. Neyman known";715;403;87;316;462;538
"4288";"3. RSIHR Known";"3. RSIHR Known";715;447;73;374;393;607
"4289";"4. Rosenberger known";"4. Rosenberger known";715;557;30;527;141;859
"4290";"5. Optimal adjusted";"5. Optimal adjusted";715;394;104;290;527;473
"4291";"1. Random";"1. Random";716;411;122;289;501;499
"4292";"6. Biased  coin";"6. Biased  coin";716;421;115;306;499;501
"4293";"2. Neyman known";"2. Neyman known";716;442;112;330;449;551
"4294";"3. RSIHR Known";"3. RSIHR Known";716;444;88;356;373;627
"4295";"4. Rosenberger known";"4. Rosenberger known";716;530;36;494;156;844
"4296";"5. Optimal adjusted";"5. Optimal adjusted";716;379;115;264;554;446
"4297";"1. Random";"1. Random";717;402;100;302;494;506
"4298";"6. Biased  coin";"6. Biased  coin";717;398;99;299;501;500
"4299";"2. Neyman known";"2. Neyman known";717;439;91;348;451;549
"4300";"3. RSIHR Known";"3. RSIHR Known";717;478;65;413;342;658
"4301";"4. Rosenberger known";"4. Rosenberger known";717;541;29;512;150;850
"4302";"5. Optimal adjusted";"5. Optimal adjusted";717;389;107;282;534;466
"4303";"1. Random";"1. Random";718;433;111;322;484;516
"4304";"6. Biased  coin";"6. Biased  coin";718;405;102;303;499;501
"4305";"2. Neyman known";"2. Neyman known";718;430;99;331;446;554
"4306";"3. RSIHR Known";"3. RSIHR Known";718;467;79;388;368;632
"4307";"4. Rosenberger known";"4. Rosenberger known";718;549;32;517;145;855
"4308";"5. Optimal adjusted";"5. Optimal adjusted";718;410;110;300;528;472
"4309";"1. Random";"1. Random";719;394;109;285;523;477
"4310";"6. Biased  coin";"6. Biased  coin";719;416;116;300;501;500
"4311";"2. Neyman known";"2. Neyman known";719;417;94;323;440;560
"4312";"3. RSIHR Known";"3. RSIHR Known";719;447;82;365;380;620
"4313";"4. Rosenberger known";"4. Rosenberger known";719;544;31;513;147;853
"4314";"5. Optimal adjusted";"5. Optimal adjusted";719;391;114;277;542;458
"4315";"1. Random";"1. Random";720;415;98;317;470;530
"4316";"6. Biased  coin";"6. Biased  coin";720;415;115;300;501;500
"4317";"2. Neyman known";"2. Neyman known";720;436;107;329;461;539
"4318";"3. RSIHR Known";"3. RSIHR Known";720;458;84;374;372;628
"4319";"4. Rosenberger known";"4. Rosenberger known";720;541;29;512;144;856
"4320";"5. Optimal adjusted";"5. Optimal adjusted";720;402;119;283;527;473
"4321";"1. Random";"1. Random";721;400;93;307;489;511
"4322";"6. Biased  coin";"6. Biased  coin";721;396;89;307;500;500
"4323";"2. Neyman known";"2. Neyman known";721;435;95;340;438;562
"4324";"3. RSIHR Known";"3. RSIHR Known";721;429;72;357;388;612
"4325";"4. Rosenberger known";"4. Rosenberger known";721;523;29;494;156;844
"4326";"5. Optimal adjusted";"5. Optimal adjusted";721;357;98;259;546;454
"4327";"1. Random";"1. Random";722;389;99;290;506;494
"4328";"6. Biased  coin";"6. Biased  coin";722;407;109;298;499;501
"4329";"2. Neyman known";"2. Neyman known";722;419;80;339;422;578
"4330";"3. RSIHR Known";"3. RSIHR Known";722;458;73;385;347;653
"4331";"4. Rosenberger known";"4. Rosenberger known";722;529;20;509;142;858
"4332";"5. Optimal adjusted";"5. Optimal adjusted";722;397;115;282;544;456
"4333";"1. Random";"1. Random";723;399;91;308;499;501
"4334";"6. Biased  coin";"6. Biased  coin";723;405;92;313;501;499
"4335";"2. Neyman known";"2. Neyman known";723;416;69;347;431;569
"4336";"3. RSIHR Known";"3. RSIHR Known";723;452;76;376;403;597
"4337";"4. Rosenberger known";"4. Rosenberger known";723;560;28;532;150;850
"4338";"5. Optimal adjusted";"5. Optimal adjusted";723;400;98;302;526;474
"4339";"1. Random";"1. Random";724;414;96;318;497;503
"4340";"6. Biased  coin";"6. Biased  coin";724;396;92;304;504;500
"4341";"2. Neyman known";"2. Neyman known";724;422;90;332;471;529
"4342";"3. RSIHR Known";"3. RSIHR Known";724;455;65;390;360;640
"4343";"4. Rosenberger known";"4. Rosenberger known";724;554;30;524;157;843
"4344";"5. Optimal adjusted";"5. Optimal adjusted";724;401;101;300;532;468
"4345";"1. Random";"1. Random";725;410;102;308;507;493
"4346";"6. Biased  coin";"6. Biased  coin";725;402;91;311;500;500
"4347";"2. Neyman known";"2. Neyman known";725;426;90;336;450;550
"4348";"3. RSIHR Known";"3. RSIHR Known";725;456;66;390;364;636
"4349";"4. Rosenberger known";"4. Rosenberger known";725;579;37;542;141;859
"4350";"5. Optimal adjusted";"5. Optimal adjusted";725;384;106;278;547;453
"4351";"1. Random";"1. Random";726;399;92;307;474;526
"4352";"6. Biased  coin";"6. Biased  coin";726;409;103;306;500;501
"4353";"2. Neyman known";"2. Neyman known";726;423;88;335;438;562
"4354";"3. RSIHR Known";"3. RSIHR Known";726;459;82;377;368;632
"4355";"4. Rosenberger known";"4. Rosenberger known";726;548;23;525;125;875
"4356";"5. Optimal adjusted";"5. Optimal adjusted";726;401;106;295;515;485
"4357";"1. Random";"1. Random";727;403;92;311;496;504
"4358";"6. Biased  coin";"6. Biased  coin";727;401;96;305;501;499
"4359";"2. Neyman known";"2. Neyman known";727;433;88;345;443;557
"4360";"3. RSIHR Known";"3. RSIHR Known";727;447;65;382;387;613
"4361";"4. Rosenberger known";"4. Rosenberger known";727;561;30;531;139;861
"4362";"5. Optimal adjusted";"5. Optimal adjusted";727;391;96;295;509;491
"4363";"1. Random";"1. Random";728;405;96;309;501;499
"4364";"6. Biased  coin";"6. Biased  coin";728;393;97;296;502;500
"4365";"2. Neyman known";"2. Neyman known";728;416;103;313;467;533
"4366";"3. RSIHR Known";"3. RSIHR Known";728;460;81;379;378;622
"4367";"4. Rosenberger known";"4. Rosenberger known";728;550;29;521;143;857
"4368";"5. Optimal adjusted";"5. Optimal adjusted";728;397;113;284;547;453
"4369";"1. Random";"1. Random";729;408;82;326;488;512
"4370";"6. Biased  coin";"6. Biased  coin";729;395;87;308;501;500
"4371";"2. Neyman known";"2. Neyman known";729;413;77;336;454;546
"4372";"3. RSIHR Known";"3. RSIHR Known";729;440;63;377;375;625
"4373";"4. Rosenberger known";"4. Rosenberger known";729;554;33;521;149;851
"4374";"5. Optimal adjusted";"5. Optimal adjusted";729;397;102;295;519;481
"4375";"1. Random";"1. Random";730;402;109;293;523;477
"4376";"6. Biased  coin";"6. Biased  coin";730;416;105;311;501;499
"4377";"2. Neyman known";"2. Neyman known";730;449;107;342;466;534
"4378";"3. RSIHR Known";"3. RSIHR Known";730;475;62;413;354;646
"4379";"4. Rosenberger known";"4. Rosenberger known";730;572;22;550;126;874
"4380";"5. Optimal adjusted";"5. Optimal adjusted";730;395;115;280;559;441
"4381";"1. Random";"1. Random";731;406;84;322;477;523
"4382";"6. Biased  coin";"6. Biased  coin";731;393;96;297;503;499
"4383";"2. Neyman known";"2. Neyman known";731;418;90;328;459;541
"4384";"3. RSIHR Known";"3. RSIHR Known";731;428;62;366;367;633
"4385";"4. Rosenberger known";"4. Rosenberger known";731;531;29;502;159;841
"4386";"5. Optimal adjusted";"5. Optimal adjusted";731;383;98;285;525;475
"4387";"1. Random";"1. Random";732;394;104;290;509;491
"4388";"6. Biased  coin";"6. Biased  coin";732;387;94;293;501;500
"4389";"2. Neyman known";"2. Neyman known";732;419;94;325;471;529
"4390";"3. RSIHR Known";"3. RSIHR Known";732;460;86;374;384;616
"4391";"4. Rosenberger known";"4. Rosenberger known";732;543;26;517;138;862
"4392";"5. Optimal adjusted";"5. Optimal adjusted";732;391;101;290;521;479
"4393";"1. Random";"1. Random";733;399;105;294;504;496
"4394";"6. Biased  coin";"6. Biased  coin";733;411;105;306;499;502
"4395";"2. Neyman known";"2. Neyman known";733;449;110;339;452;548
"4396";"3. RSIHR Known";"3. RSIHR Known";733;472;76;396;343;657
"4397";"4. Rosenberger known";"4. Rosenberger known";733;546;25;521;156;844
"4398";"5. Optimal adjusted";"5. Optimal adjusted";733;410;110;300;521;479
"4399";"1. Random";"1. Random";734;421;102;319;509;491
"4400";"6. Biased  coin";"6. Biased  coin";734;422;95;327;501;501
"4401";"2. Neyman known";"2. Neyman known";734;428;80;348;443;557
"4402";"3. RSIHR Known";"3. RSIHR Known";734;454;77;377;388;612
"4403";"4. Rosenberger known";"4. Rosenberger known";734;574;24;550;135;865
"4404";"5. Optimal adjusted";"5. Optimal adjusted";734;389;100;289;556;444
"4405";"1. Random";"1. Random";735;412;91;321;504;496
"4406";"6. Biased  coin";"6. Biased  coin";735;423;96;327;500;500
"4407";"2. Neyman known";"2. Neyman known";735;428;68;360;439;561
"4408";"3. RSIHR Known";"3. RSIHR Known";735;476;56;420;345;655
"4409";"4. Rosenberger known";"4. Rosenberger known";735;566;24;542;153;847
"4410";"5. Optimal adjusted";"5. Optimal adjusted";735;389;99;290;556;444
"4411";"1. Random";"1. Random";736;409;107;302;513;487
"4412";"6. Biased  coin";"6. Biased  coin";736;383;88;295;500;500
"4413";"2. Neyman known";"2. Neyman known";736;427;87;340;436;564
"4414";"3. RSIHR Known";"3. RSIHR Known";736;471;69;402;349;651
"4415";"4. Rosenberger known";"4. Rosenberger known";736;530;36;494;172;828
"4416";"5. Optimal adjusted";"5. Optimal adjusted";736;382;89;293;510;490
"4417";"1. Random";"1. Random";737;417;92;325;478;522
"4418";"6. Biased  coin";"6. Biased  coin";737;390;90;300;500;500
"4419";"2. Neyman known";"2. Neyman known";737;408;87;321;463;537
"4420";"3. RSIHR Known";"3. RSIHR Known";737;445;76;369;371;629
"4421";"4. Rosenberger known";"4. Rosenberger known";737;542;29;513;141;859
"4422";"5. Optimal adjusted";"5. Optimal adjusted";737;346;89;257;566;434
"4423";"1. Random";"1. Random";738;389;92;297;500;500
"4424";"6. Biased  coin";"6. Biased  coin";738;389;93;296;501;500
"4425";"2. Neyman known";"2. Neyman known";738;400;88;312;459;541
"4426";"3. RSIHR Known";"3. RSIHR Known";738;451;59;392;338;662
"4427";"4. Rosenberger known";"4. Rosenberger known";738;547;27;520;141;859
"4428";"5. Optimal adjusted";"5. Optimal adjusted";738;366;110;256;566;434
"4429";"1. Random";"1. Random";739;403;100;303;509;491
"4430";"6. Biased  coin";"6. Biased  coin";739;406;90;316;503;500
"4431";"2. Neyman known";"2. Neyman known";739;429;97;332;433;567
"4432";"3. RSIHR Known";"3. RSIHR Known";739;445;67;378;372;628
"4433";"4. Rosenberger known";"4. Rosenberger known";739;537;22;515;147;853
"4434";"5. Optimal adjusted";"5. Optimal adjusted";739;371;101;270;536;464
"4435";"1. Random";"1. Random";740;373;76;297;484;516
"4436";"6. Biased  coin";"6. Biased  coin";740;392;98;294;501;500
"4437";"2. Neyman known";"2. Neyman known";740;419;69;350;433;567
"4438";"3. RSIHR Known";"3. RSIHR Known";740;451;75;376;399;601
"4439";"4. Rosenberger known";"4. Rosenberger known";740;550;22;528;139;861
"4440";"5. Optimal adjusted";"5. Optimal adjusted";740;400;102;298;533;467
"4441";"1. Random";"1. Random";741;411;98;313;496;504
"4442";"6. Biased  coin";"6. Biased  coin";741;421;99;322;501;499
"4443";"2. Neyman known";"2. Neyman known";741;433;78;355;426;574
"4444";"3. RSIHR Known";"3. RSIHR Known";741;480;69;411;344;656
"4445";"4. Rosenberger known";"4. Rosenberger known";741;573;36;537;136;864
"4446";"5. Optimal adjusted";"5. Optimal adjusted";741;403;116;287;559;441
"4447";"1. Random";"1. Random";742;407;99;308;488;512
"4448";"6. Biased  coin";"6. Biased  coin";742;401;107;294;500;501
"4449";"2. Neyman known";"2. Neyman known";742;431;92;339;457;543
"4450";"3. RSIHR Known";"3. RSIHR Known";742;460;71;389;353;647
"4451";"4. Rosenberger known";"4. Rosenberger known";742;542;34;508;154;846
"4452";"5. Optimal adjusted";"5. Optimal adjusted";742;376;101;275;526;474
"4453";"1. Random";"1. Random";743;384;95;289;501;499
"4454";"6. Biased  coin";"6. Biased  coin";743;396;102;294;500;500
"4455";"2. Neyman known";"2. Neyman known";743;413;98;315;470;530
"4456";"3. RSIHR Known";"3. RSIHR Known";743;463;76;387;350;650
"4457";"4. Rosenberger known";"4. Rosenberger known";743;518;31;487;174;826
"4458";"5. Optimal adjusted";"5. Optimal adjusted";743;384;110;274;551;449
"4459";"1. Random";"1. Random";744;386;89;297;495;505
"4460";"6. Biased  coin";"6. Biased  coin";744;424;118;306;501;500
"4461";"2. Neyman known";"2. Neyman known";744;420;92;328;451;549
"4462";"3. RSIHR Known";"3. RSIHR Known";744;428;72;356;383;617
"4463";"4. Rosenberger known";"4. Rosenberger known";744;542;25;517;125;875
"4464";"5. Optimal adjusted";"5. Optimal adjusted";744;367;112;255;549;451
"4465";"1. Random";"1. Random";745;389;86;303;491;509
"4466";"6. Biased  coin";"6. Biased  coin";745;370;93;277;502;499
"4467";"2. Neyman known";"2. Neyman known";745;384;68;316;462;538
"4468";"3. RSIHR Known";"3. RSIHR Known";745;436;67;369;370;630
"4469";"4. Rosenberger known";"4. Rosenberger known";745;533;33;500;132;868
"4470";"5. Optimal adjusted";"5. Optimal adjusted";745;347;88;259;535;465
"4471";"1. Random";"1. Random";746;404;94;310;474;526
"4472";"6. Biased  coin";"6. Biased  coin";746;386;96;290;500;500
"4473";"2. Neyman known";"2. Neyman known";746;429;99;330;457;543
"4474";"3. RSIHR Known";"3. RSIHR Known";746;457;77;380;372;628
"4475";"4. Rosenberger known";"4. Rosenberger known";746;540;26;514;138;862
"4476";"5. Optimal adjusted";"5. Optimal adjusted";746;388;110;278;552;448
"4477";"1. Random";"1. Random";747;393;98;295;500;500
"4478";"6. Biased  coin";"6. Biased  coin";747;400;106;294;502;500
"4479";"2. Neyman known";"2. Neyman known";747;415;85;330;427;573
"4480";"3. RSIHR Known";"3. RSIHR Known";747;474;75;399;363;637
"4481";"4. Rosenberger known";"4. Rosenberger known";747;537;19;518;123;877
"4482";"5. Optimal adjusted";"5. Optimal adjusted";747;383;122;261;571;429
"4483";"1. Random";"1. Random";748;414;102;312;492;508
"4484";"6. Biased  coin";"6. Biased  coin";748;418;108;310;500;500
"4485";"2. Neyman known";"2. Neyman known";748;440;88;352;428;572
"4486";"3. RSIHR Known";"3. RSIHR Known";748;480;86;394;370;630
"4487";"4. Rosenberger known";"4. Rosenberger known";748;540;30;510;155;845
"4488";"5. Optimal adjusted";"5. Optimal adjusted";748;395;109;286;524;476
"4489";"1. Random";"1. Random";749;393;102;291;512;488
"4490";"6. Biased  coin";"6. Biased  coin";749;389;99;290;501;500
"4491";"2. Neyman known";"2. Neyman known";749;438;96;342;435;565
"4492";"3. RSIHR Known";"3. RSIHR Known";749;471;89;382;370;630
"4493";"4. Rosenberger known";"4. Rosenberger known";749;527;36;491;165;835
"4494";"5. Optimal adjusted";"5. Optimal adjusted";749;407;103;304;506;494
"4495";"1. Random";"1. Random";750;397;89;308;488;512
"4496";"6. Biased  coin";"6. Biased  coin";750;400;97;303;502;499
"4497";"2. Neyman known";"2. Neyman known";750;424;90;334;445;555
"4498";"3. RSIHR Known";"3. RSIHR Known";750;440;81;359;405;595
"4499";"4. Rosenberger known";"4. Rosenberger known";750;540;14;526;124;876
"4500";"5. Optimal adjusted";"5. Optimal adjusted";750;390;101;289;521;479
"4501";"1. Random";"1. Random";751;400;104;296;518;482
"4502";"6. Biased  coin";"6. Biased  coin";751;394;101;293;504;499
"4503";"2. Neyman known";"2. Neyman known";751;442;90;352;455;545
"4504";"3. RSIHR Known";"3. RSIHR Known";751;478;70;408;354;646
"4505";"4. Rosenberger known";"4. Rosenberger known";751;542;23;519;138;862
"4506";"5. Optimal adjusted";"5. Optimal adjusted";751;395;102;293;516;484
"4507";"1. Random";"1. Random";752;398;101;297;510;490
"4508";"6. Biased  coin";"6. Biased  coin";752;416;111;305;500;501
"4509";"2. Neyman known";"2. Neyman known";752;412;92;320;451;549
"4510";"3. RSIHR Known";"3. RSIHR Known";752;444;72;372;370;630
"4511";"4. Rosenberger known";"4. Rosenberger known";752;545;32;513;144;856
"4512";"5. Optimal adjusted";"5. Optimal adjusted";752;389;101;288;531;469
"4513";"1. Random";"1. Random";753;418;92;326;481;519
"4514";"6. Biased  coin";"6. Biased  coin";753;401;94;307;500;500
"4515";"2. Neyman known";"2. Neyman known";753;423;90;333;454;546
"4516";"3. RSIHR Known";"3. RSIHR Known";753;475;68;407;349;651
"4517";"4. Rosenberger known";"4. Rosenberger known";753;551;19;532;133;867
"4518";"5. Optimal adjusted";"5. Optimal adjusted";753;391;114;277;550;450
"4519";"1. Random";"1. Random";754;405;98;307;516;484
"4520";"6. Biased  coin";"6. Biased  coin";754;409;105;304;498;503
"4521";"2. Neyman known";"2. Neyman known";754;426;89;337;443;557
"4522";"3. RSIHR Known";"3. RSIHR Known";754;444;80;364;384;616
"4523";"4. Rosenberger known";"4. Rosenberger known";754;564;29;535;144;856
"4524";"5. Optimal adjusted";"5. Optimal adjusted";754;400;113;287;532;468
"4525";"1. Random";"1. Random";755;397;109;288;507;493
"4526";"6. Biased  coin";"6. Biased  coin";755;417;112;305;502;500
"4527";"2. Neyman known";"2. Neyman known";755;417;97;320;459;541
"4528";"3. RSIHR Known";"3. RSIHR Known";755;436;89;347;397;603
"4529";"4. Rosenberger known";"4. Rosenberger known";755;546;31;515;130;870
"4530";"5. Optimal adjusted";"5. Optimal adjusted";755;387;122;265;543;457
"4531";"1. Random";"1. Random";756;402;106;296;533;467
"4532";"6. Biased  coin";"6. Biased  coin";756;399;96;303;499;501
"4533";"2. Neyman known";"2. Neyman known";756;419;87;332;459;541
"4534";"3. RSIHR Known";"3. RSIHR Known";756;466;85;381;370;630
"4535";"4. Rosenberger known";"4. Rosenberger known";756;569;25;544;128;872
"4536";"5. Optimal adjusted";"5. Optimal adjusted";756;399;93;306;508;492
"4537";"1. Random";"1. Random";757;401;88;313;483;517
"4538";"6. Biased  coin";"6. Biased  coin";757;406;98;308;500;500
"4539";"2. Neyman known";"2. Neyman known";757;457;90;367;414;586
"4540";"3. RSIHR Known";"3. RSIHR Known";757;469;57;412;362;638
"4541";"4. Rosenberger known";"4. Rosenberger known";757;561;28;533;148;852
"4542";"5. Optimal adjusted";"5. Optimal adjusted";757;396;107;289;538;462
"4543";"1. Random";"1. Random";758;375;91;284;510;490
"4544";"6. Biased  coin";"6. Biased  coin";758;381;95;286;500;501
"4545";"2. Neyman known";"2. Neyman known";758;408;78;330;427;573
"4546";"3. RSIHR Known";"3. RSIHR Known";758;460;73;387;357;643
"4547";"4. Rosenberger known";"4. Rosenberger known";758;533;32;501;142;858
"4548";"5. Optimal adjusted";"5. Optimal adjusted";758;390;127;263;552;448
"4549";"1. Random";"1. Random";759;367;83;284;491;509
"4550";"6. Biased  coin";"6. Biased  coin";759;377;85;292;501;500
"4551";"2. Neyman known";"2. Neyman known";759;385;89;296;480;520
"4552";"3. RSIHR Known";"3. RSIHR Known";759;455;67;388;374;626
"4553";"4. Rosenberger known";"4. Rosenberger known";759;535;36;499;151;849
"4554";"5. Optimal adjusted";"5. Optimal adjusted";759;374;91;283;537;463
"4555";"1. Random";"1. Random";760;388;94;294;502;498
"4556";"6. Biased  coin";"6. Biased  coin";760;415;101;314;500;500
"4557";"2. Neyman known";"2. Neyman known";760;425;89;336;459;541
"4558";"3. RSIHR Known";"3. RSIHR Known";760;458;69;389;364;636
"4559";"4. Rosenberger known";"4. Rosenberger known";760;531;21;510;140;860
"4560";"5. Optimal adjusted";"5. Optimal adjusted";760;390;108;282;531;469
"4561";"1. Random";"1. Random";761;388;108;280;524;476
"4562";"6. Biased  coin";"6. Biased  coin";761;403;103;300;500;500
"4563";"2. Neyman known";"2. Neyman known";761;426;90;336;442;558
"4564";"3. RSIHR Known";"3. RSIHR Known";761;468;79;389;359;641
"4565";"4. Rosenberger known";"4. Rosenberger known";761;546;26;520;147;853
"4566";"5. Optimal adjusted";"5. Optimal adjusted";761;399;107;292;534;466
"4567";"1. Random";"1. Random";762;408;95;313;480;520
"4568";"6. Biased  coin";"6. Biased  coin";762;393;95;298;501;500
"4569";"2. Neyman known";"2. Neyman known";762;410;94;316;466;534
"4570";"3. RSIHR Known";"3. RSIHR Known";762;460;64;396;341;659
"4571";"4. Rosenberger known";"4. Rosenberger known";762;563;27;536;133;867
"4572";"5. Optimal adjusted";"5. Optimal adjusted";762;399;102;297;516;484
"4573";"1. Random";"1. Random";763;412;92;320;487;513
"4574";"6. Biased  coin";"6. Biased  coin";763;421;98;323;501;499
"4575";"2. Neyman known";"2. Neyman known";763;453;101;352;461;539
"4576";"3. RSIHR Known";"3. RSIHR Known";763;470;67;403;348;652
"4577";"4. Rosenberger known";"4. Rosenberger known";763;536;25;511;165;835
"4578";"5. Optimal adjusted";"5. Optimal adjusted";763;387;107;280;538;462
"4579";"1. Random";"1. Random";764;404;97;307;503;497
"4580";"6. Biased  coin";"6. Biased  coin";764;378;88;290;502;500
"4581";"2. Neyman known";"2. Neyman known";764;413;93;320;466;534
"4582";"3. RSIHR Known";"3. RSIHR Known";764;437;66;371;383;617
"4583";"4. Rosenberger known";"4. Rosenberger known";764;535;28;507;139;861
"4584";"5. Optimal adjusted";"5. Optimal adjusted";764;369;101;268;544;456
"4585";"1. Random";"1. Random";765;391;115;276;541;459
"4586";"6. Biased  coin";"6. Biased  coin";765;409;105;304;502;499
"4587";"2. Neyman known";"2. Neyman known";765;418;85;333;450;550
"4588";"3. RSIHR Known";"3. RSIHR Known";765;458;72;386;357;643
"4589";"4. Rosenberger known";"4. Rosenberger known";765;553;24;529;141;859
"4590";"5. Optimal adjusted";"5. Optimal adjusted";765;402;109;293;522;478
"4591";"1. Random";"1. Random";766;396;102;294;516;484
"4592";"6. Biased  coin";"6. Biased  coin";766;396;101;295;502;499
"4593";"2. Neyman known";"2. Neyman known";766;441;86;355;430;570
"4594";"3. RSIHR Known";"3. RSIHR Known";766;449;79;370;396;604
"4595";"4. Rosenberger known";"4. Rosenberger known";766;543;29;514;142;858
"4596";"5. Optimal adjusted";"5. Optimal adjusted";766;385;99;286;507;493
"4597";"1. Random";"1. Random";767;420;99;321;479;521
"4598";"6. Biased  coin";"6. Biased  coin";767;401;95;306;500;500
"4599";"2. Neyman known";"2. Neyman known";767;428;78;350;440;560
"4600";"3. RSIHR Known";"3. RSIHR Known";767;462;67;395;367;633
"4601";"4. Rosenberger known";"4. Rosenberger known";767;558;29;529;134;866
"4602";"5. Optimal adjusted";"5. Optimal adjusted";767;386;102;284;532;468
"4603";"1. Random";"1. Random";768;399;102;297;504;496
"4604";"6. Biased  coin";"6. Biased  coin";768;402;110;292;502;501
"4605";"2. Neyman known";"2. Neyman known";768;444;102;342;431;569
"4606";"3. RSIHR Known";"3. RSIHR Known";768;453;74;379;362;638
"4607";"4. Rosenberger known";"4. Rosenberger known";768;543;19;524;126;874
"4608";"5. Optimal adjusted";"5. Optimal adjusted";768;410;103;307;516;484
"4609";"1. Random";"1. Random";769;389;100;289;522;478
"4610";"6. Biased  coin";"6. Biased  coin";769;393;99;294;500;500
"4611";"2. Neyman known";"2. Neyman known";769;423;82;341;429;571
"4612";"3. RSIHR Known";"3. RSIHR Known";769;463;72;391;346;654
"4613";"4. Rosenberger known";"4. Rosenberger known";769;537;30;507;145;855
"4614";"5. Optimal adjusted";"5. Optimal adjusted";769;406;118;288;533;467
"4615";"1. Random";"1. Random";770;418;109;309;491;509
"4616";"6. Biased  coin";"6. Biased  coin";770;405;96;309;501;500
"4617";"2. Neyman known";"2. Neyman known";770;432;96;336;456;544
"4618";"3. RSIHR Known";"3. RSIHR Known";770;458;78;380;381;619
"4619";"4. Rosenberger known";"4. Rosenberger known";770;559;30;529;160;840
"4620";"5. Optimal adjusted";"5. Optimal adjusted";770;390;104;286;538;462
"4621";"1. Random";"1. Random";771;415;88;327;472;528
"4622";"6. Biased  coin";"6. Biased  coin";771;400;94;306;505;499
"4623";"2. Neyman known";"2. Neyman known";771;437;94;343;437;563
"4624";"3. RSIHR Known";"3. RSIHR Known";771;467;58;409;348;652
"4625";"4. Rosenberger known";"4. Rosenberger known";771;561;29;532;142;858
"4626";"5. Optimal adjusted";"5. Optimal adjusted";771;388;96;292;518;482
"4627";"1. Random";"1. Random";772;393;98;295;513;487
"4628";"6. Biased  coin";"6. Biased  coin";772;406;89;317;501;501
"4629";"2. Neyman known";"2. Neyman known";772;441;90;351;436;564
"4630";"3. RSIHR Known";"3. RSIHR Known";772;454;73;381;391;609
"4631";"4. Rosenberger known";"4. Rosenberger known";772;556;23;533;147;853
"4632";"5. Optimal adjusted";"5. Optimal adjusted";772;404;89;315;493;507
"4633";"1. Random";"1. Random";773;375;91;284;495;505
"4634";"6. Biased  coin";"6. Biased  coin";773;383;92;291;499;501
"4635";"2. Neyman known";"2. Neyman known";773;398;85;313;467;533
"4636";"3. RSIHR Known";"3. RSIHR Known";773;441;58;383;344;656
"4637";"4. Rosenberger known";"4. Rosenberger known";773;519;23;496;141;859
"4638";"5. Optimal adjusted";"5. Optimal adjusted";773;368;106;262;547;453
"4639";"1. Random";"1. Random";774;420;98;322;481;519
"4640";"6. Biased  coin";"6. Biased  coin";774;424;123;301;500;501
"4641";"2. Neyman known";"2. Neyman known";774;447;98;349;450;550
"4642";"3. RSIHR Known";"3. RSIHR Known";774;481;74;407;330;670
"4643";"4. Rosenberger known";"4. Rosenberger known";774;556;37;519;151;849
"4644";"5. Optimal adjusted";"5. Optimal adjusted";774;392;109;283;534;466
"4645";"1. Random";"1. Random";775;399;101;298;503;497
"4646";"6. Biased  coin";"6. Biased  coin";775;384;94;290;500;501
"4647";"2. Neyman known";"2. Neyman known";775;411;96;315;467;533
"4648";"3. RSIHR Known";"3. RSIHR Known";775;444;59;385;348;652
"4649";"4. Rosenberger known";"4. Rosenberger known";775;532;27;505;147;853
"4650";"5. Optimal adjusted";"5. Optimal adjusted";775;376;98;278;544;456
"4651";"1. Random";"1. Random";776;393;100;293;521;479
"4652";"6. Biased  coin";"6. Biased  coin";776;385;86;299;501;500
"4653";"2. Neyman known";"2. Neyman known";776;425;89;336;456;544
"4654";"3. RSIHR Known";"3. RSIHR Known";776;452;75;377;367;633
"4655";"4. Rosenberger known";"4. Rosenberger known";776;529;32;497;161;839
"4656";"5. Optimal adjusted";"5. Optimal adjusted";776;378;99;279;534;466
"4657";"1. Random";"1. Random";777;385;94;291;494;506
"4658";"6. Biased  coin";"6. Biased  coin";777;403;102;301;499;501
"4659";"2. Neyman known";"2. Neyman known";777;406;86;320;455;545
"4660";"3. RSIHR Known";"3. RSIHR Known";777;458;65;393;346;654
"4661";"4. Rosenberger known";"4. Rosenberger known";777;528;29;499;151;849
"4662";"5. Optimal adjusted";"5. Optimal adjusted";777;384;99;285;521;479
"4663";"1. Random";"1. Random";778;409;98;311;496;504
"4664";"6. Biased  coin";"6. Biased  coin";778;411;99;312;503;500
"4665";"2. Neyman known";"2. Neyman known";778;417;93;324;465;535
"4666";"3. RSIHR Known";"3. RSIHR Known";778;450;75;375;364;636
"4667";"4. Rosenberger known";"4. Rosenberger known";778;555;26;529;145;855
"4668";"5. Optimal adjusted";"5. Optimal adjusted";778;382;106;276;538;462
"4669";"1. Random";"1. Random";779;392;106;286;511;489
"4670";"6. Biased  coin";"6. Biased  coin";779;416;103;313;500;501
"4671";"2. Neyman known";"2. Neyman known";779;434;91;343;434;566
"4672";"3. RSIHR Known";"3. RSIHR Known";779;470;73;397;359;641
"4673";"4. Rosenberger known";"4. Rosenberger known";779;566;26;540;128;872
"4674";"5. Optimal adjusted";"5. Optimal adjusted";779;367;107;260;552;448
"4675";"1. Random";"1. Random";780;429;98;331;481;519
"4676";"6. Biased  coin";"6. Biased  coin";780;419;108;311;501;499
"4677";"2. Neyman known";"2. Neyman known";780;436;96;340;456;544
"4678";"3. RSIHR Known";"3. RSIHR Known";780;468;71;397;365;635
"4679";"4. Rosenberger known";"4. Rosenberger known";780;583;36;547;137;863
"4680";"5. Optimal adjusted";"5. Optimal adjusted";780;386;107;279;535;465
"4681";"1. Random";"1. Random";781;442;112;330;468;532
"4682";"6. Biased  coin";"6. Biased  coin";781;438;120;318;499;501
"4683";"2. Neyman known";"2. Neyman known";781;436;112;324;481;519
"4684";"3. RSIHR Known";"3. RSIHR Known";781;479;83;396;359;641
"4685";"4. Rosenberger known";"4. Rosenberger known";781;576;30;546;128;872
"4686";"5. Optimal adjusted";"5. Optimal adjusted";781;383;109;274;535;465
"4687";"1. Random";"1. Random";782;406;86;320;488;512
"4688";"6. Biased  coin";"6. Biased  coin";782;399;100;299;500;500
"4689";"2. Neyman known";"2. Neyman known";782;467;107;360;438;562
"4690";"3. RSIHR Known";"3. RSIHR Known";782;454;75;379;394;606
"4691";"4. Rosenberger known";"4. Rosenberger known";782;562;23;539;134;866
"4692";"5. Optimal adjusted";"5. Optimal adjusted";782;399;120;279;540;460
"4693";"1. Random";"1. Random";783;405;92;313;497;503
"4694";"6. Biased  coin";"6. Biased  coin";783;401;90;311;497;503
"4695";"2. Neyman known";"2. Neyman known";783;434;72;362;423;577
"4696";"3. RSIHR Known";"3. RSIHR Known";783;442;86;356;426;574
"4697";"4. Rosenberger known";"4. Rosenberger known";783;565;37;528;137;863
"4698";"5. Optimal adjusted";"5. Optimal adjusted";783;387;110;277;555;445
"4699";"1. Random";"1. Random";784;403;103;300;501;499
"4700";"6. Biased  coin";"6. Biased  coin";784;412;100;312;501;500
"4701";"2. Neyman known";"2. Neyman known";784;419;92;327;452;548
"4702";"3. RSIHR Known";"3. RSIHR Known";784;471;70;401;338;662
"4703";"4. Rosenberger known";"4. Rosenberger known";784;556;30;526;140;860
"4704";"5. Optimal adjusted";"5. Optimal adjusted";784;382;115;267;541;459
"4705";"1. Random";"1. Random";785;423;104;319;487;513
"4706";"6. Biased  coin";"6. Biased  coin";785;400;108;292;500;500
"4707";"2. Neyman known";"2. Neyman known";785;412;98;314;458;542
"4708";"3. RSIHR Known";"3. RSIHR Known";785;473;84;389;369;631
"4709";"4. Rosenberger known";"4. Rosenberger known";785;554;33;521;141;859
"4710";"5. Optimal adjusted";"5. Optimal adjusted";785;384;128;256;563;437
"4711";"1. Random";"1. Random";786;375;99;276;516;484
"4712";"6. Biased  coin";"6. Biased  coin";786;404;102;302;500;500
"4713";"2. Neyman known";"2. Neyman known";786;413;95;318;456;544
"4714";"3. RSIHR Known";"3. RSIHR Known";786;449;64;385;337;663
"4715";"4. Rosenberger known";"4. Rosenberger known";786;527;28;499;145;855
"4716";"5. Optimal adjusted";"5. Optimal adjusted";786;380;102;278;533;467
"4717";"1. Random";"1. Random";787;396;93;303;497;503
"4718";"6. Biased  coin";"6. Biased  coin";787;408;88;320;501;500
"4719";"2. Neyman known";"2. Neyman known";787;460;94;366;421;579
"4720";"3. RSIHR Known";"3. RSIHR Known";787;483;68;415;350;650
"4721";"4. Rosenberger known";"4. Rosenberger known";787;576;15;561;119;881
"4722";"5. Optimal adjusted";"5. Optimal adjusted";787;377;94;283;556;444
"4723";"1. Random";"1. Random";788;380;88;292;481;519
"4724";"6. Biased  coin";"6. Biased  coin";788;393;100;293;500;501
"4725";"2. Neyman known";"2. Neyman known";788;409;77;332;422;578
"4726";"3. RSIHR Known";"3. RSIHR Known";788;445;70;375;372;628
"4727";"4. Rosenberger known";"4. Rosenberger known";788;520;21;499;143;857
"4728";"5. Optimal adjusted";"5. Optimal adjusted";788;364;101;263;548;452
"4729";"1. Random";"1. Random";789;411;94;317;486;514
"4730";"6. Biased  coin";"6. Biased  coin";789;398;96;302;499;501
"4731";"2. Neyman known";"2. Neyman known";789;397;81;316;465;535
"4732";"3. RSIHR Known";"3. RSIHR Known";789;466;66;400;344;656
"4733";"4. Rosenberger known";"4. Rosenberger known";789;565;28;537;132;868
"4734";"5. Optimal adjusted";"5. Optimal adjusted";789;396;113;283;545;455
"4735";"1. Random";"1. Random";790;403;99;304;494;506
"4736";"6. Biased  coin";"6. Biased  coin";790;426;112;314;500;500
"4737";"2. Neyman known";"2. Neyman known";790;421;100;321;480;520
"4738";"3. RSIHR Known";"3. RSIHR Known";790;448;73;375;396;604
"4739";"4. Rosenberger known";"4. Rosenberger known";790;565;34;531;158;842
"4740";"5. Optimal adjusted";"5. Optimal adjusted";790;380;96;284;539;461
"4741";"1. Random";"1. Random";791;392;94;298;497;503
"4742";"6. Biased  coin";"6. Biased  coin";791;415;110;305;502;500
"4743";"2. Neyman known";"2. Neyman known";791;440;92;348;443;557
"4744";"3. RSIHR Known";"3. RSIHR Known";791;487;88;399;358;642
"4745";"4. Rosenberger known";"4. Rosenberger known";791;566;29;537;131;869
"4746";"5. Optimal adjusted";"5. Optimal adjusted";791;423;111;312;514;486
"4747";"1. Random";"1. Random";792;343;92;251;547;453
"4748";"6. Biased  coin";"6. Biased  coin";792;387;105;282;500;500
"4749";"2. Neyman known";"2. Neyman known";792;368;83;285;464;536
"4750";"3. RSIHR Known";"3. RSIHR Known";792;403;64;339;391;609
"4751";"4. Rosenberger known";"4. Rosenberger known";792;514;23;491;123;877
"4752";"5. Optimal adjusted";"5. Optimal adjusted";792;368;104;264;538;462
"4753";"1. Random";"1. Random";793;390;92;298;482;518
"4754";"6. Biased  coin";"6. Biased  coin";793;388;89;299;500;500
"4755";"2. Neyman known";"2. Neyman known";793;414;81;333;441;559
"4756";"3. RSIHR Known";"3. RSIHR Known";793;464;77;387;353;647
"4757";"4. Rosenberger known";"4. Rosenberger known";793;549;37;512;149;851
"4758";"5. Optimal adjusted";"5. Optimal adjusted";793;364;100;264;550;450
"4759";"1. Random";"1. Random";794;407;88;319;482;518
"4760";"6. Biased  coin";"6. Biased  coin";794;398;87;311;501;500
"4761";"2. Neyman known";"2. Neyman known";794;427;94;333;483;517
"4762";"3. RSIHR Known";"3. RSIHR Known";794;458;65;393;355;645
"4763";"4. Rosenberger known";"4. Rosenberger known";794;568;21;547;130;870
"4764";"5. Optimal adjusted";"5. Optimal adjusted";794;396;106;290;537;463
"4765";"1. Random";"1. Random";795;395;94;301;487;513
"4766";"6. Biased  coin";"6. Biased  coin";795;392;89;303;501;499
"4767";"2. Neyman known";"2. Neyman known";795;412;90;322;457;543
"4768";"3. RSIHR Known";"3. RSIHR Known";795;436;66;370;367;633
"4769";"4. Rosenberger known";"4. Rosenberger known";795;533;29;504;146;854
"4770";"5. Optimal adjusted";"5. Optimal adjusted";795;378;106;272;558;442
"4771";"1. Random";"1. Random";796;401;109;292;499;501
"4772";"6. Biased  coin";"6. Biased  coin";796;414;123;291;501;499
"4773";"2. Neyman known";"2. Neyman known";796;407;108;299;471;529
"4774";"3. RSIHR Known";"3. RSIHR Known";796;456;94;362;379;621
"4775";"4. Rosenberger known";"4. Rosenberger known";796;546;24;522;118;882
"4776";"5. Optimal adjusted";"5. Optimal adjusted";796;410;124;286;545;455
"4777";"1. Random";"1. Random";797;404;100;304;507;493
"4778";"6. Biased  coin";"6. Biased  coin";797;408;98;310;500;500
"4779";"2. Neyman known";"2. Neyman known";797;398;79;319;439;561
"4780";"3. RSIHR Known";"3. RSIHR Known";797;452;77;375;380;620
"4781";"4. Rosenberger known";"4. Rosenberger known";797;540;28;512;163;837
"4782";"5. Optimal adjusted";"5. Optimal adjusted";797;402;107;295;534;466
"4783";"1. Random";"1. Random";798;401;95;306;488;512
"4784";"6. Biased  coin";"6. Biased  coin";798;418;104;314;500;501
"4785";"2. Neyman known";"2. Neyman known";798;429;92;337;461;539
"4786";"3. RSIHR Known";"3. RSIHR Known";798;485;72;413;350;650
"4787";"4. Rosenberger known";"4. Rosenberger known";798;554;22;532;132;868
"4788";"5. Optimal adjusted";"5. Optimal adjusted";798;405;120;285;536;464
"4789";"1. Random";"1. Random";799;391;84;307;493;507
"4790";"6. Biased  coin";"6. Biased  coin";799;386;90;296;501;500
"4791";"2. Neyman known";"2. Neyman known";799;417;89;328;454;546
"4792";"3. RSIHR Known";"3. RSIHR Known";799;442;66;376;369;631
"4793";"4. Rosenberger known";"4. Rosenberger known";799;533;28;505;153;847
"4794";"5. Optimal adjusted";"5. Optimal adjusted";799;375;102;273;538;462
"4795";"1. Random";"1. Random";800;389;85;304;472;528
"4796";"6. Biased  coin";"6. Biased  coin";800;421;104;317;501;500
"4797";"2. Neyman known";"2. Neyman known";800;423;107;316;489;511
"4798";"3. RSIHR Known";"3. RSIHR Known";800;467;80;387;366;634
"4799";"4. Rosenberger known";"4. Rosenberger known";800;563;26;537;120;880
"4800";"5. Optimal adjusted";"5. Optimal adjusted";800;384;108;276;549;451
"4801";"1. Random";"1. Random";801;391;90;301;477;523
"4802";"6. Biased  coin";"6. Biased  coin";801;384;88;296;501;500
"4803";"2. Neyman known";"2. Neyman known";801;391;91;300;465;535
"4804";"3. RSIHR Known";"3. RSIHR Known";801;424;70;354;391;609
"4805";"4. Rosenberger known";"4. Rosenberger known";801;528;26;502;140;860
"4806";"5. Optimal adjusted";"5. Optimal adjusted";801;380;117;263;554;446
"4807";"1. Random";"1. Random";802;388;98;290;518;482
"4808";"6. Biased  coin";"6. Biased  coin";802;431;112;319;501;500
"4809";"2. Neyman known";"2. Neyman known";802;429;99;330;457;543
"4810";"3. RSIHR Known";"3. RSIHR Known";802;463;70;393;356;644
"4811";"4. Rosenberger known";"4. Rosenberger known";802;556;32;524;145;855
"4812";"5. Optimal adjusted";"5. Optimal adjusted";802;411;111;300;512;488
"4813";"1. Random";"1. Random";803;370;92;278;508;492
"4814";"6. Biased  coin";"6. Biased  coin";803;408;94;314;502;500
"4815";"2. Neyman known";"2. Neyman known";803;418;85;333;441;559
"4816";"3. RSIHR Known";"3. RSIHR Known";803;442;70;372;375;625
"4817";"4. Rosenberger known";"4. Rosenberger known";803;552;30;522;146;854
"4818";"5. Optimal adjusted";"5. Optimal adjusted";803;382;102;280;529;471
"4819";"1. Random";"1. Random";804;405;102;303;510;490
"4820";"6. Biased  coin";"6. Biased  coin";804;424;114;310;501;500
"4821";"2. Neyman known";"2. Neyman known";804;409;79;330;453;547
"4822";"3. RSIHR Known";"3. RSIHR Known";804;450;78;372;386;614
"4823";"4. Rosenberger known";"4. Rosenberger known";804;565;32;533;148;852
"4824";"5. Optimal adjusted";"5. Optimal adjusted";804;405;110;295;521;479
"4825";"1. Random";"1. Random";805;421;101;320;475;525
"4826";"6. Biased  coin";"6. Biased  coin";805;406;98;308;499;501
"4827";"2. Neyman known";"2. Neyman known";805;418;89;329;454;546
"4828";"3. RSIHR Known";"3. RSIHR Known";805;448;80;368;374;626
"4829";"4. Rosenberger known";"4. Rosenberger known";805;546;21;525;137;863
"4830";"5. Optimal adjusted";"5. Optimal adjusted";805;381;105;276;539;461
"4831";"1. Random";"1. Random";806;401;81;320;483;517
"4832";"6. Biased  coin";"6. Biased  coin";806;386;93;293;499;501
"4833";"2. Neyman known";"2. Neyman known";806;428;81;347;439;561
"4834";"3. RSIHR Known";"3. RSIHR Known";806;435;75;360;400;600
"4835";"4. Rosenberger known";"4. Rosenberger known";806;557;31;526;131;869
"4836";"5. Optimal adjusted";"5. Optimal adjusted";806;377;94;283;529;471
"4837";"1. Random";"1. Random";807;403;108;295;476;524
"4838";"6. Biased  coin";"6. Biased  coin";807;382;92;290;502;498
"4839";"2. Neyman known";"2. Neyman known";807;433;94;339;436;564
"4840";"3. RSIHR Known";"3. RSIHR Known";807;452;78;374;385;615
"4841";"4. Rosenberger known";"4. Rosenberger known";807;536;35;501;155;845
"4842";"5. Optimal adjusted";"5. Optimal adjusted";807;379;111;268;532;468
"4843";"1. Random";"1. Random";808;381;95;286;502;498
"4844";"6. Biased  coin";"6. Biased  coin";808;403;101;302;503;500
"4845";"2. Neyman known";"2. Neyman known";808;417;89;328;439;561
"4846";"3. RSIHR Known";"3. RSIHR Known";808;447;80;367;372;628
"4847";"4. Rosenberger known";"4. Rosenberger known";808;529;25;504;138;862
"4848";"5. Optimal adjusted";"5. Optimal adjusted";808;364;95;269;528;472
"4849";"1. Random";"1. Random";809;397;98;299;517;483
"4850";"6. Biased  coin";"6. Biased  coin";809;411;103;308;504;499
"4851";"2. Neyman known";"2. Neyman known";809;440;98;342;450;550
"4852";"3. RSIHR Known";"3. RSIHR Known";809;451;73;378;381;619
"4853";"4. Rosenberger known";"4. Rosenberger known";809;548;22;526;130;870
"4854";"5. Optimal adjusted";"5. Optimal adjusted";809;387;119;268;557;443
"4855";"1. Random";"1. Random";810;394;99;295;488;512
"4856";"6. Biased  coin";"6. Biased  coin";810;400;103;297;499;501
"4857";"2. Neyman known";"2. Neyman known";810;419;97;322;463;537
"4858";"3. RSIHR Known";"3. RSIHR Known";810;455;84;371;382;618
"4859";"4. Rosenberger known";"4. Rosenberger known";810;553;32;521;137;863
"4860";"5. Optimal adjusted";"5. Optimal adjusted";810;390;113;277;520;480
"4861";"1. Random";"1. Random";811;419;101;318;481;519
"4862";"6. Biased  coin";"6. Biased  coin";811;412;111;301;500;500
"4863";"2. Neyman known";"2. Neyman known";811;409;90;319;470;530
"4864";"3. RSIHR Known";"3. RSIHR Known";811;446;71;375;362;638
"4865";"4. Rosenberger known";"4. Rosenberger known";811;532;22;510;147;853
"4866";"5. Optimal adjusted";"5. Optimal adjusted";811;394;115;279;535;465
"4867";"1. Random";"1. Random";812;395;104;291;532;468
"4868";"6. Biased  coin";"6. Biased  coin";812;405;103;302;500;500
"4869";"2. Neyman known";"2. Neyman known";812;439;77;362;427;573
"4870";"3. RSIHR Known";"3. RSIHR Known";812;452;75;377;380;620
"4871";"4. Rosenberger known";"4. Rosenberger known";812;544;19;525;146;854
"4872";"5. Optimal adjusted";"5. Optimal adjusted";812;389;96;293;530;470
"4873";"1. Random";"1. Random";813;394;99;295;507;493
"4874";"6. Biased  coin";"6. Biased  coin";813;413;99;314;500;500
"4875";"2. Neyman known";"2. Neyman known";813;401;82;319;446;554
"4876";"3. RSIHR Known";"3. RSIHR Known";813;451;59;392;351;649
"4877";"4. Rosenberger known";"4. Rosenberger known";813;527;26;501;160;840
"4878";"5. Optimal adjusted";"5. Optimal adjusted";813;376;98;278;526;474
"4879";"1. Random";"1. Random";814;395;90;305;495;505
"4880";"6. Biased  coin";"6. Biased  coin";814;393;93;300;498;502
"4881";"2. Neyman known";"2. Neyman known";814;431;83;348;421;579
"4882";"3. RSIHR Known";"3. RSIHR Known";814;446;61;385;365;635
"4883";"4. Rosenberger known";"4. Rosenberger known";814;535;28;507;149;851
"4884";"5. Optimal adjusted";"5. Optimal adjusted";814;380;108;272;537;463
"4885";"1. Random";"1. Random";815;419;108;311;487;513
"4886";"6. Biased  coin";"6. Biased  coin";815;411;112;299;500;500
"4887";"2. Neyman known";"2. Neyman known";815;428;100;328;445;555
"4888";"3. RSIHR Known";"3. RSIHR Known";815;451;78;373;371;629
"4889";"4. Rosenberger known";"4. Rosenberger known";815;538;30;508;143;857
"4890";"5. Optimal adjusted";"5. Optimal adjusted";815;384;107;277;531;469
"4891";"1. Random";"1. Random";816;384;94;290;490;510
"4892";"6. Biased  coin";"6. Biased  coin";816;381;97;284;501;499
"4893";"2. Neyman known";"2. Neyman known";816;398;94;304;459;541
"4894";"3. RSIHR Known";"3. RSIHR Known";816;421;66;355;360;640
"4895";"4. Rosenberger known";"4. Rosenberger known";816;495;28;467;168;832
"4896";"5. Optimal adjusted";"5. Optimal adjusted";816;363;109;254;550;450
"4897";"1. Random";"1. Random";817;407;118;289;543;457
"4898";"6. Biased  coin";"6. Biased  coin";817;409;99;310;502;499
"4899";"2. Neyman known";"2. Neyman known";817;419;79;340;438;562
"4900";"3. RSIHR Known";"3. RSIHR Known";817;466;71;395;372;628
"4901";"4. Rosenberger known";"4. Rosenberger known";817;552;26;526;134;866
"4902";"5. Optimal adjusted";"5. Optimal adjusted";817;412;121;291;523;477
"4903";"1. Random";"1. Random";818;375;103;272;504;496
"4904";"6. Biased  coin";"6. Biased  coin";818;395;106;289;502;499
"4905";"2. Neyman known";"2. Neyman known";818;409;85;324;451;549
"4906";"3. RSIHR Known";"3. RSIHR Known";818;437;67;370;370;630
"4907";"4. Rosenberger known";"4. Rosenberger known";818;525;26;499;132;868
"4908";"5. Optimal adjusted";"5. Optimal adjusted";818;371;110;261;560;440
"4909";"1. Random";"1. Random";819;409;99;310;510;490
"4910";"6. Biased  coin";"6. Biased  coin";819;410;95;315;501;499
"4911";"2. Neyman known";"2. Neyman known";819;416;90;326;447;553
"4912";"3. RSIHR Known";"3. RSIHR Known";819;459;79;380;397;603
"4913";"4. Rosenberger known";"4. Rosenberger known";819;554;29;525;157;843
"4914";"5. Optimal adjusted";"5. Optimal adjusted";819;407;109;298;528;472
"4915";"1. Random";"1. Random";820;391;91;300;500;500
"4916";"6. Biased  coin";"6. Biased  coin";820;388;82;306;499;501
"4917";"2. Neyman known";"2. Neyman known";820;400;72;328;455;545
"4918";"3. RSIHR Known";"3. RSIHR Known";820;444;55;389;351;649
"4919";"4. Rosenberger known";"4. Rosenberger known";820;557;23;534;137;863
"4920";"5. Optimal adjusted";"5. Optimal adjusted";820;379;91;288;521;479
"4921";"1. Random";"1. Random";821;386;98;288;527;473
"4922";"6. Biased  coin";"6. Biased  coin";821;427;102;325;501;500
"4923";"2. Neyman known";"2. Neyman known";821;442;86;356;431;569
"4924";"3. RSIHR Known";"3. RSIHR Known";821;484;66;418;351;649
"4925";"4. Rosenberger known";"4. Rosenberger known";821;554;21;533;143;857
"4926";"5. Optimal adjusted";"5. Optimal adjusted";821;399;101;298;534;466
"4927";"1. Random";"1. Random";822;415;101;314;500;500
"4928";"6. Biased  coin";"6. Biased  coin";822;404;98;306;500;500
"4929";"2. Neyman known";"2. Neyman known";822;434;104;330;451;549
"4930";"3. RSIHR Known";"3. RSIHR Known";822;470;83;387;377;623
"4931";"4. Rosenberger known";"4. Rosenberger known";822;546;31;515;156;844
"4932";"5. Optimal adjusted";"5. Optimal adjusted";822;382;113;269;557;443
"4933";"1. Random";"1. Random";823;380;84;296;497;503
"4934";"6. Biased  coin";"6. Biased  coin";823;391;86;305;500;501
"4935";"2. Neyman known";"2. Neyman known";823;391;77;314;474;526
"4936";"3. RSIHR Known";"3. RSIHR Known";823;433;60;373;359;641
"4937";"4. Rosenberger known";"4. Rosenberger known";823;546;23;523;125;875
"4938";"5. Optimal adjusted";"5. Optimal adjusted";823;379;103;276;541;459
"4939";"1. Random";"1. Random";824;427;114;313;510;490
"4940";"6. Biased  coin";"6. Biased  coin";824;418;113;305;500;500
"4941";"2. Neyman known";"2. Neyman known";824;421;98;323;470;530
"4942";"3. RSIHR Known";"3. RSIHR Known";824;484;78;406;350;650
"4943";"4. Rosenberger known";"4. Rosenberger known";824;543;25;518;142;858
"4944";"5. Optimal adjusted";"5. Optimal adjusted";824;397;106;291;538;462
"4945";"1. Random";"1. Random";825;387;92;295;498;502
"4946";"6. Biased  coin";"6. Biased  coin";825;380;92;288;499;501
"4947";"2. Neyman known";"2. Neyman known";825;387;88;299;481;519
"4948";"3. RSIHR Known";"3. RSIHR Known";825;433;76;357;387;613
"4949";"4. Rosenberger known";"4. Rosenberger known";825;540;31;509;151;849
"4950";"5. Optimal adjusted";"5. Optimal adjusted";825;403;100;303;506;494
"4951";"1. Random";"1. Random";826;420;104;316;493;507
"4952";"6. Biased  coin";"6. Biased  coin";826;412;105;307;501;501
"4953";"2. Neyman known";"2. Neyman known";826;424;89;335;436;564
"4954";"3. RSIHR Known";"3. RSIHR Known";826;458;66;392;354;646
"4955";"4. Rosenberger known";"4. Rosenberger known";826;551;35;516;159;841
"4956";"5. Optimal adjusted";"5. Optimal adjusted";826;405;112;293;534;466
"4957";"1. Random";"1. Random";827;408;98;310;493;507
"4958";"6. Biased  coin";"6. Biased  coin";827;397;94;303;501;499
"4959";"2. Neyman known";"2. Neyman known";827;429;91;338;452;548
"4960";"3. RSIHR Known";"3. RSIHR Known";827;454;70;384;367;633
"4961";"4. Rosenberger known";"4. Rosenberger known";827;553;25;528;147;853
"4962";"5. Optimal adjusted";"5. Optimal adjusted";827;384;90;294;520;480
"4963";"1. Random";"1. Random";828;402;109;293;503;497
"4964";"6. Biased  coin";"6. Biased  coin";828;392;107;285;501;500
"4965";"2. Neyman known";"2. Neyman known";828;440;101;339;423;577
"4966";"3. RSIHR Known";"3. RSIHR Known";828;469;77;392;354;646
"4967";"4. Rosenberger known";"4. Rosenberger known";828;539;28;511;137;863
"4968";"5. Optimal adjusted";"5. Optimal adjusted";828;393;125;268;553;447
"4969";"1. Random";"1. Random";829;404;104;300;493;507
"4970";"6. Biased  coin";"6. Biased  coin";829;394;99;295;501;500
"4971";"2. Neyman known";"2. Neyman known";829;418;95;323;443;557
"4972";"3. RSIHR Known";"3. RSIHR Known";829;442;75;367;370;630
"4973";"4. Rosenberger known";"4. Rosenberger known";829;535;33;502;144;856
"4974";"5. Optimal adjusted";"5. Optimal adjusted";829;399;98;301;501;499
"4975";"1. Random";"1. Random";830;382;91;291;524;476
"4976";"6. Biased  coin";"6. Biased  coin";830;391;95;296;502;499
"4977";"2. Neyman known";"2. Neyman known";830;400;81;319;460;540
"4978";"3. RSIHR Known";"3. RSIHR Known";830;463;58;405;335;665
"4979";"4. Rosenberger known";"4. Rosenberger known";830;535;21;514;151;849
"4980";"5. Optimal adjusted";"5. Optimal adjusted";830;365;83;282;528;472
"4981";"1. Random";"1. Random";831;429;104;325;480;520
"4982";"6. Biased  coin";"6. Biased  coin";831;412;106;306;500;501
"4983";"2. Neyman known";"2. Neyman known";831;417;83;334;440;560
"4984";"3. RSIHR Known";"3. RSIHR Known";831;463;82;381;373;627
"4985";"4. Rosenberger known";"4. Rosenberger known";831;553;27;526;125;875
"4986";"5. Optimal adjusted";"5. Optimal adjusted";831;379;113;266;557;443
"4987";"1. Random";"1. Random";832;407;102;305;502;498
"4988";"6. Biased  coin";"6. Biased  coin";832;396;99;297;499;502
"4989";"2. Neyman known";"2. Neyman known";832;430;90;340;450;550
"4990";"3. RSIHR Known";"3. RSIHR Known";832;472;75;397;361;639
"4991";"4. Rosenberger known";"4. Rosenberger known";832;551;33;518;130;870
"4992";"5. Optimal adjusted";"5. Optimal adjusted";832;393;109;284;527;473
"4993";"1. Random";"1. Random";833;397;104;293;518;482
"4994";"6. Biased  coin";"6. Biased  coin";833;413;102;311;501;500
"4995";"2. Neyman known";"2. Neyman known";833;442;101;341;468;532
"4996";"3. RSIHR Known";"3. RSIHR Known";833;478;73;405;358;642
"4997";"4. Rosenberger known";"4. Rosenberger known";833;557;28;529;154;846
"4998";"5. Optimal adjusted";"5. Optimal adjusted";833;402;130;272;579;421
"4999";"1. Random";"1. Random";834;397;101;296;497;503
"5000";"6. Biased  coin";"6. Biased  coin";834;408;106;302;503;500
"5001";"2. Neyman known";"2. Neyman known";834;421;93;328;452;548
"5002";"3. RSIHR Known";"3. RSIHR Known";834;467;71;396;323;677
"5003";"4. Rosenberger known";"4. Rosenberger known";834;543;31;512;144;856
"5004";"5. Optimal adjusted";"5. Optimal adjusted";834;383;111;272;530;470
"5005";"1. Random";"1. Random";835;413;108;305;506;494
"5006";"6. Biased  coin";"6. Biased  coin";835;395;95;300;500;500
"5007";"2. Neyman known";"2. Neyman known";835;430;85;345;430;570
"5008";"3. RSIHR Known";"3. RSIHR Known";835;468;74;394;334;666
"5009";"4. Rosenberger known";"4. Rosenberger known";835;544;29;515;137;863
"5010";"5. Optimal adjusted";"5. Optimal adjusted";835;384;103;281;528;472
"5011";"1. Random";"1. Random";836;390;86;304;496;504
"5012";"6. Biased  coin";"6. Biased  coin";836;386;85;301;503;500
"5013";"2. Neyman known";"2. Neyman known";836;404;82;322;449;551
"5014";"3. RSIHR Known";"3. RSIHR Known";836;444;71;373;371;629
"5015";"4. Rosenberger known";"4. Rosenberger known";836;546;23;523;131;869
"5016";"5. Optimal adjusted";"5. Optimal adjusted";836;378;95;283;529;471
"5017";"1. Random";"1. Random";837;362;87;275;501;499
"5018";"6. Biased  coin";"6. Biased  coin";837;355;81;274;501;501
"5019";"2. Neyman known";"2. Neyman known";837;413;84;329;437;563
"5020";"3. RSIHR Known";"3. RSIHR Known";837;423;63;360;374;626
"5021";"4. Rosenberger known";"4. Rosenberger known";837;518;24;494;133;867
"5022";"5. Optimal adjusted";"5. Optimal adjusted";837;371;101;270;533;467
"5023";"1. Random";"1. Random";838;403;101;302;493;507
"5024";"6. Biased  coin";"6. Biased  coin";838;394;106;288;504;497
"5025";"2. Neyman known";"2. Neyman known";838;399;83;316;468;532
"5026";"3. RSIHR Known";"3. RSIHR Known";838;439;71;368;364;636
"5027";"4. Rosenberger known";"4. Rosenberger known";838;519;30;489;151;849
"5028";"5. Optimal adjusted";"5. Optimal adjusted";838;393;109;284;543;457
"5029";"1. Random";"1. Random";839;386;103;283;538;462
"5030";"6. Biased  coin";"6. Biased  coin";839;395;95;300;501;500
"5031";"2. Neyman known";"2. Neyman known";839;389;74;315;449;551
"5032";"3. RSIHR Known";"3. RSIHR Known";839;442;69;373;393;607
"5033";"4. Rosenberger known";"4. Rosenberger known";839;544;25;519;146;854
"5034";"5. Optimal adjusted";"5. Optimal adjusted";839;365;94;271;541;459
"5035";"1. Random";"1. Random";840;408;104;304;501;499
"5036";"6. Biased  coin";"6. Biased  coin";840;437;112;325;499;502
"5037";"2. Neyman known";"2. Neyman known";840;458;96;362;454;546
"5038";"3. RSIHR Known";"3. RSIHR Known";840;503;84;419;343;657
"5039";"4. Rosenberger known";"4. Rosenberger known";840;564;25;539;150;850
"5040";"5. Optimal adjusted";"5. Optimal adjusted";840;399;114;285;544;456
"5041";"1. Random";"1. Random";841;386;96;290;496;504
"5042";"6. Biased  coin";"6. Biased  coin";841;378;93;285;501;500
"5043";"2. Neyman known";"2. Neyman known";841;399;80;319;445;555
"5044";"3. RSIHR Known";"3. RSIHR Known";841;457;69;388;347;653
"5045";"4. Rosenberger known";"4. Rosenberger known";841;530;26;504;147;853
"5046";"5. Optimal adjusted";"5. Optimal adjusted";841;360;116;244;544;456
"5047";"1. Random";"1. Random";842;391;97;294;494;506
"5048";"6. Biased  coin";"6. Biased  coin";842;395;104;291;501;500
"5049";"2. Neyman known";"2. Neyman known";842;386;86;300;478;522
"5050";"3. RSIHR Known";"3. RSIHR Known";842;459;81;378;394;606
"5051";"4. Rosenberger known";"4. Rosenberger known";842;535;19;516;132;868
"5052";"5. Optimal adjusted";"5. Optimal adjusted";842;386;111;275;543;457
"5053";"1. Random";"1. Random";843;426;108;318;500;500
"5054";"6. Biased  coin";"6. Biased  coin";843;421;115;306;503;500
"5055";"2. Neyman known";"2. Neyman known";843;439;103;336;440;560
"5056";"3. RSIHR Known";"3. RSIHR Known";843;462;83;379;378;622
"5057";"4. Rosenberger known";"4. Rosenberger known";843;556;29;527;137;863
"5058";"5. Optimal adjusted";"5. Optimal adjusted";843;416;123;293;531;469
"5059";"1. Random";"1. Random";844;408;96;312;491;509
"5060";"6. Biased  coin";"6. Biased  coin";844;398;93;305;501;500
"5061";"2. Neyman known";"2. Neyman known";844;422;87;335;444;556
"5062";"3. RSIHR Known";"3. RSIHR Known";844;448;61;387;350;650
"5063";"4. Rosenberger known";"4. Rosenberger known";844;534;25;509;143;857
"5064";"5. Optimal adjusted";"5. Optimal adjusted";844;381;98;283;528;472
"5065";"1. Random";"1. Random";845;419;109;310;507;493
"5066";"6. Biased  coin";"6. Biased  coin";845;379;100;279;502;500
"5067";"2. Neyman known";"2. Neyman known";845;428;105;323;476;524
"5068";"3. RSIHR Known";"3. RSIHR Known";845;469;88;381;375;625
"5069";"4. Rosenberger known";"4. Rosenberger known";845;563;33;530;125;875
"5070";"5. Optimal adjusted";"5. Optimal adjusted";845;378;121;257;565;435
"5071";"1. Random";"1. Random";846;391;91;300;511;489
"5072";"6. Biased  coin";"6. Biased  coin";846;407;94;313;500;500
"5073";"2. Neyman known";"2. Neyman known";846;435;83;352;452;548
"5074";"3. RSIHR Known";"3. RSIHR Known";846;461;61;400;360;640
"5075";"4. Rosenberger known";"4. Rosenberger known";846;560;24;536;146;854
"5076";"5. Optimal adjusted";"5. Optimal adjusted";846;393;95;298;527;473
"5077";"1. Random";"1. Random";847;414;109;305;496;504
"5078";"6. Biased  coin";"6. Biased  coin";847;429;116;313;500;500
"5079";"2. Neyman known";"2. Neyman known";847;432;90;342;458;542
"5080";"3. RSIHR Known";"3. RSIHR Known";847;471;80;391;352;648
"5081";"4. Rosenberger known";"4. Rosenberger known";847;559;34;525;148;852
"5082";"5. Optimal adjusted";"5. Optimal adjusted";847;405;108;297;519;481
"5083";"1. Random";"1. Random";848;373;92;281;501;499
"5084";"6. Biased  coin";"6. Biased  coin";848;376;90;286;500;500
"5085";"2. Neyman known";"2. Neyman known";848;393;93;300;468;532
"5086";"3. RSIHR Known";"3. RSIHR Known";848;451;72;379;364;636
"5087";"4. Rosenberger known";"4. Rosenberger known";848;520;23;497;141;859
"5088";"5. Optimal adjusted";"5. Optimal adjusted";848;389;102;287;532;468
"5089";"1. Random";"1. Random";849;423;117;306;506;494
"5090";"6. Biased  coin";"6. Biased  coin";849;402;108;294;501;499
"5091";"2. Neyman known";"2. Neyman known";849;427;94;333;442;558
"5092";"3. RSIHR Known";"3. RSIHR Known";849;458;87;371;379;621
"5093";"4. Rosenberger known";"4. Rosenberger known";849;540;28;512;143;857
"5094";"5. Optimal adjusted";"5. Optimal adjusted";849;400;115;285;525;475
"5095";"1. Random";"1. Random";850;383;101;282;518;482
"5096";"6. Biased  coin";"6. Biased  coin";850;391;97;294;500;501
"5097";"2. Neyman known";"2. Neyman known";850;409;77;332;435;565
"5098";"3. RSIHR Known";"3. RSIHR Known";850;461;74;387;345;655
"5099";"4. Rosenberger known";"4. Rosenberger known";850;531;29;502;136;864
"5100";"5. Optimal adjusted";"5. Optimal adjusted";850;387;104;283;529;471
"5101";"1. Random";"1. Random";851;399;82;317;492;508
"5102";"6. Biased  coin";"6. Biased  coin";851;415;89;326;499;501
"5103";"2. Neyman known";"2. Neyman known";851;434;76;358;421;579
"5104";"3. RSIHR Known";"3. RSIHR Known";851;448;69;379;393;607
"5105";"4. Rosenberger known";"4. Rosenberger known";851;552;28;524;145;855
"5106";"5. Optimal adjusted";"5. Optimal adjusted";851;384;94;290;522;478
"5107";"1. Random";"1. Random";852;396;92;304;485;515
"5108";"6. Biased  coin";"6. Biased  coin";852;395;92;303;500;501
"5109";"2. Neyman known";"2. Neyman known";852;438;98;340;457;543
"5110";"3. RSIHR Known";"3. RSIHR Known";852;445;71;374;381;619
"5111";"4. Rosenberger known";"4. Rosenberger known";852;534;21;513;139;861
"5112";"5. Optimal adjusted";"5. Optimal adjusted";852;392;106;286;520;480
"5113";"1. Random";"1. Random";853;397;100;297;502;498
"5114";"6. Biased  coin";"6. Biased  coin";853;424;108;316;500;500
"5115";"2. Neyman known";"2. Neyman known";853;414;93;321;467;533
"5116";"3. RSIHR Known";"3. RSIHR Known";853;470;68;402;356;644
"5117";"4. Rosenberger known";"4. Rosenberger known";853;565;30;535;131;869
"5118";"5. Optimal adjusted";"5. Optimal adjusted";853;411;104;307;511;489
"5119";"1. Random";"1. Random";854;407;102;305;502;498
"5120";"6. Biased  coin";"6. Biased  coin";854;399;95;304;502;498
"5121";"2. Neyman known";"2. Neyman known";854;431;87;344;451;549
"5122";"3. RSIHR Known";"3. RSIHR Known";854;453;70;383;374;626
"5123";"4. Rosenberger known";"4. Rosenberger known";854;539;23;516;155;845
"5124";"5. Optimal adjusted";"5. Optimal adjusted";854;401;124;277;560;440
"5125";"1. Random";"1. Random";855;394;92;302;489;511
"5126";"6. Biased  coin";"6. Biased  coin";855;391;93;298;499;501
"5127";"2. Neyman known";"2. Neyman known";855;401;89;312;474;526
"5128";"3. RSIHR Known";"3. RSIHR Known";855;483;76;407;332;668
"5129";"4. Rosenberger known";"4. Rosenberger known";855;543;22;521;133;867
"5130";"5. Optimal adjusted";"5. Optimal adjusted";855;390;110;280;541;459
"5131";"1. Random";"1. Random";856;395;94;301;502;498
"5132";"6. Biased  coin";"6. Biased  coin";856;387;97;290;500;500
"5133";"2. Neyman known";"2. Neyman known";856;408;90;318;474;526
"5134";"3. RSIHR Known";"3. RSIHR Known";856;471;72;399;362;638
"5135";"4. Rosenberger known";"4. Rosenberger known";856;544;26;518;151;849
"5136";"5. Optimal adjusted";"5. Optimal adjusted";856;366;95;271;553;447
"5137";"1. Random";"1. Random";857;389;104;285;509;491
"5138";"6. Biased  coin";"6. Biased  coin";857;418;112;306;503;498
"5139";"2. Neyman known";"2. Neyman known";857;409;92;317;462;538
"5140";"3. RSIHR Known";"3. RSIHR Known";857;450;60;390;328;672
"5141";"4. Rosenberger known";"4. Rosenberger known";857;516;23;493;140;860
"5142";"5. Optimal adjusted";"5. Optimal adjusted";857;389;104;285;527;473
"5143";"1. Random";"1. Random";858;405;86;319;485;515
"5144";"6. Biased  coin";"6. Biased  coin";858;427;115;312;499;501
"5145";"2. Neyman known";"2. Neyman known";858;423;96;327;471;529
"5146";"3. RSIHR Known";"3. RSIHR Known";858;468;71;397;360;640
"5147";"4. Rosenberger known";"4. Rosenberger known";858;547;22;525;125;875
"5148";"5. Optimal adjusted";"5. Optimal adjusted";858;395;117;278;543;457
"5149";"1. Random";"1. Random";859;397;89;308;487;513
"5150";"6. Biased  coin";"6. Biased  coin";859;390;93;297;501;500
"5151";"2. Neyman known";"2. Neyman known";859;439;89;350;430;570
"5152";"3. RSIHR Known";"3. RSIHR Known";859;446;62;384;354;646
"5153";"4. Rosenberger known";"4. Rosenberger known";859;543;29;514;132;868
"5154";"5. Optimal adjusted";"5. Optimal adjusted";859;384;92;292;509;491
"5155";"1. Random";"1. Random";860;417;101;316;482;518
"5156";"6. Biased  coin";"6. Biased  coin";860;410;112;298;500;500
"5157";"2. Neyman known";"2. Neyman known";860;417;101;316;463;537
"5158";"3. RSIHR Known";"3. RSIHR Known";860;463;82;381;366;634
"5159";"4. Rosenberger known";"4. Rosenberger known";860;560;29;531;132;868
"5160";"5. Optimal adjusted";"5. Optimal adjusted";860;406;106;300;514;486
"5161";"1. Random";"1. Random";861;379;88;291;523;477
"5162";"6. Biased  coin";"6. Biased  coin";861;384;85;299;499;502
"5163";"2. Neyman known";"2. Neyman known";861;401;75;326;444;556
"5164";"3. RSIHR Known";"3. RSIHR Known";861;434;69;365;384;616
"5165";"4. Rosenberger known";"4. Rosenberger known";861;544;22;522;143;857
"5166";"5. Optimal adjusted";"5. Optimal adjusted";861;372;90;282;511;489
"5167";"1. Random";"1. Random";862;387;95;292;505;495
"5168";"6. Biased  coin";"6. Biased  coin";862;399;97;302;500;500
"5169";"2. Neyman known";"2. Neyman known";862;414;96;318;470;530
"5170";"3. RSIHR Known";"3. RSIHR Known";862;435;66;369;353;647
"5171";"4. Rosenberger known";"4. Rosenberger known";862;523;26;497;141;859
"5172";"5. Optimal adjusted";"5. Optimal adjusted";862;385;103;282;527;473
"5173";"1. Random";"1. Random";863;388;93;295;528;472
"5174";"6. Biased  coin";"6. Biased  coin";863;401;92;309;501;499
"5175";"2. Neyman known";"2. Neyman known";863;445;77;368;426;574
"5176";"3. RSIHR Known";"3. RSIHR Known";863;490;64;426;343;657
"5177";"4. Rosenberger known";"4. Rosenberger known";863;549;26;523;146;854
"5178";"5. Optimal adjusted";"5. Optimal adjusted";863;401;101;300;522;478
"5179";"1. Random";"1. Random";864;413;92;321;477;523
"5180";"6. Biased  coin";"6. Biased  coin";864;425;113;312;499;501
"5181";"2. Neyman known";"2. Neyman known";864;424;93;331;463;537
"5182";"3. RSIHR Known";"3. RSIHR Known";864;461;69;392;352;648
"5183";"4. Rosenberger known";"4. Rosenberger known";864;554;19;535;113;887
"5184";"5. Optimal adjusted";"5. Optimal adjusted";864;398;111;287;531;469
"5185";"1. Random";"1. Random";865;406;113;293;499;501
"5186";"6. Biased  coin";"6. Biased  coin";865;393;103;290;499;501
"5187";"2. Neyman known";"2. Neyman known";865;437;99;338;431;569
"5188";"3. RSIHR Known";"3. RSIHR Known";865;465;71;394;361;639
"5189";"4. Rosenberger known";"4. Rosenberger known";865;547;38;509;152;848
"5190";"5. Optimal adjusted";"5. Optimal adjusted";865;402;106;296;527;473
"5191";"1. Random";"1. Random";866;353;91;262;536;464
"5192";"6. Biased  coin";"6. Biased  coin";866;388;99;289;500;500
"5193";"2. Neyman known";"2. Neyman known";866;418;100;318;456;544
"5194";"3. RSIHR Known";"3. RSIHR Known";866;435;81;354;399;601
"5195";"4. Rosenberger known";"4. Rosenberger known";866;516;22;494;144;856
"5196";"5. Optimal adjusted";"5. Optimal adjusted";866;378;94;284;527;473
"5197";"1. Random";"1. Random";867;409;99;310;503;497
"5198";"6. Biased  coin";"6. Biased  coin";867;389;92;297;501;499
"5199";"2. Neyman known";"2. Neyman known";867;416;79;337;443;557
"5200";"3. RSIHR Known";"3. RSIHR Known";867;461;79;382;372;628
"5201";"4. Rosenberger known";"4. Rosenberger known";867;542;21;521;142;858
"5202";"5. Optimal adjusted";"5. Optimal adjusted";867;372;89;283;516;484
"5203";"1. Random";"1. Random";868;406;100;306;505;495
"5204";"6. Biased  coin";"6. Biased  coin";868;403;108;295;500;501
"5205";"2. Neyman known";"2. Neyman known";868;445;90;355;439;561
"5206";"3. RSIHR Known";"3. RSIHR Known";868;461;77;384;368;632
"5207";"4. Rosenberger known";"4. Rosenberger known";868;564;29;535;142;858
"5208";"5. Optimal adjusted";"5. Optimal adjusted";868;405;109;296;512;488
"5209";"1. Random";"1. Random";869;387;86;301;500;500
"5210";"6. Biased  coin";"6. Biased  coin";869;411;103;308;501;500
"5211";"2. Neyman known";"2. Neyman known";869;425;94;331;467;533
"5212";"3. RSIHR Known";"3. RSIHR Known";869;461;66;395;363;637
"5213";"4. Rosenberger known";"4. Rosenberger known";869;550;26;524;147;853
"5214";"5. Optimal adjusted";"5. Optimal adjusted";869;374;111;263;574;426
"5215";"1. Random";"1. Random";870;404;84;320;482;518
"5216";"6. Biased  coin";"6. Biased  coin";870;405;90;315;499;501
"5217";"2. Neyman known";"2. Neyman known";870;422;92;330;464;536
"5218";"3. RSIHR Known";"3. RSIHR Known";870;465;71;394;364;636
"5219";"4. Rosenberger known";"4. Rosenberger known";870;537;18;519;134;866
"5220";"5. Optimal adjusted";"5. Optimal adjusted";870;376;99;277;556;444
"5221";"1. Random";"1. Random";871;418;112;306;483;517
"5222";"6. Biased  coin";"6. Biased  coin";871;399;98;301;501;501
"5223";"2. Neyman known";"2. Neyman known";871;443;98;345;435;565
"5224";"3. RSIHR Known";"3. RSIHR Known";871;485;82;403;352;648
"5225";"4. Rosenberger known";"4. Rosenberger known";871;532;29;503;156;844
"5226";"5. Optimal adjusted";"5. Optimal adjusted";871;375;115;260;555;445
"5227";"1. Random";"1. Random";872;401;94;307;484;516
"5228";"6. Biased  coin";"6. Biased  coin";872;401;101;300;499;502
"5229";"2. Neyman known";"2. Neyman known";872;440;87;353;418;582
"5230";"3. RSIHR Known";"3. RSIHR Known";872;454;67;387;353;647
"5231";"4. Rosenberger known";"4. Rosenberger known";872;549;38;511;148;852
"5232";"5. Optimal adjusted";"5. Optimal adjusted";872;387;112;275;533;467
"5233";"1. Random";"1. Random";873;407;93;314;482;518
"5234";"6. Biased  coin";"6. Biased  coin";873;418;99;319;500;500
"5235";"2. Neyman known";"2. Neyman known";873;422;88;334;456;544
"5236";"3. RSIHR Known";"3. RSIHR Known";873;455;60;395;364;636
"5237";"4. Rosenberger known";"4. Rosenberger known";873;560;18;542;143;857
"5238";"5. Optimal adjusted";"5. Optimal adjusted";873;399;104;295;529;471
"5239";"1. Random";"1. Random";874;421;121;300;513;487
"5240";"6. Biased  coin";"6. Biased  coin";874;416;114;302;502;499
"5241";"2. Neyman known";"2. Neyman known";874;438;90;348;424;576
"5242";"3. RSIHR Known";"3. RSIHR Known";874;474;83;391;351;649
"5243";"4. Rosenberger known";"4. Rosenberger known";874;551;32;519;145;855
"5244";"5. Optimal adjusted";"5. Optimal adjusted";874;412;117;295;529;471
"5245";"1. Random";"1. Random";875;404;96;308;482;518
"5246";"6. Biased  coin";"6. Biased  coin";875;401;100;301;500;500
"5247";"2. Neyman known";"2. Neyman known";875;427;78;349;413;587
"5248";"3. RSIHR Known";"3. RSIHR Known";875;456;68;388;356;644
"5249";"4. Rosenberger known";"4. Rosenberger known";875;558;37;521;146;854
"5250";"5. Optimal adjusted";"5. Optimal adjusted";875;396;105;291;520;480
"5251";"1. Random";"1. Random";876;398;110;288;511;489
"5252";"6. Biased  coin";"6. Biased  coin";876;401;99;302;507;498
"5253";"2. Neyman known";"2. Neyman known";876;432;100;332;468;532
"5254";"3. RSIHR Known";"3. RSIHR Known";876;470;81;389;369;631
"5255";"4. Rosenberger known";"4. Rosenberger known";876;532;31;501;153;847
"5256";"5. Optimal adjusted";"5. Optimal adjusted";876;401;120;281;545;455
"5257";"1. Random";"1. Random";877;421;102;319;491;509
"5258";"6. Biased  coin";"6. Biased  coin";877;405;95;310;500;501
"5259";"2. Neyman known";"2. Neyman known";877;456;104;352;462;538
"5260";"3. RSIHR Known";"3. RSIHR Known";877;456;63;393;350;650
"5261";"4. Rosenberger known";"4. Rosenberger known";877;553;19;534;132;868
"5262";"5. Optimal adjusted";"5. Optimal adjusted";877;364;106;258;565;435
"5263";"1. Random";"1. Random";878;426;113;313;507;493
"5264";"6. Biased  coin";"6. Biased  coin";878;417;105;312;500;502
"5265";"2. Neyman known";"2. Neyman known";878;439;102;337;431;569
"5266";"3. RSIHR Known";"3. RSIHR Known";878;478;84;394;374;626
"5267";"4. Rosenberger known";"4. Rosenberger known";878;563;25;538;140;860
"5268";"5. Optimal adjusted";"5. Optimal adjusted";878;434;134;300;541;459
"5269";"1. Random";"1. Random";879;429;112;317;481;519
"5270";"6. Biased  coin";"6. Biased  coin";879;398;106;292;500;500
"5271";"2. Neyman known";"2. Neyman known";879;431;89;342;450;550
"5272";"3. RSIHR Known";"3. RSIHR Known";879;464;93;371;383;617
"5273";"4. Rosenberger known";"4. Rosenberger known";879;552;34;518;135;865
"5274";"5. Optimal adjusted";"5. Optimal adjusted";879;380;127;253;557;443
"5275";"1. Random";"1. Random";880;395;100;295;494;506
"5276";"6. Biased  coin";"6. Biased  coin";880;396;84;312;501;500
"5277";"2. Neyman known";"2. Neyman known";880;415;77;338;429;571
"5278";"3. RSIHR Known";"3. RSIHR Known";880;454;66;388;359;641
"5279";"4. Rosenberger known";"4. Rosenberger known";880;547;25;522;133;867
"5280";"5. Optimal adjusted";"5. Optimal adjusted";880;361;92;269;540;460
"5281";"1. Random";"1. Random";881;394;87;307;478;522
"5282";"6. Biased  coin";"6. Biased  coin";881;396;84;312;501;499
"5283";"2. Neyman known";"2. Neyman known";881;385;67;318;427;573
"5284";"3. RSIHR Known";"3. RSIHR Known";881;408;59;349;382;618
"5285";"4. Rosenberger known";"4. Rosenberger known";881;529;30;499;130;870
"5286";"5. Optimal adjusted";"5. Optimal adjusted";881;351;86;265;546;454
"5287";"1. Random";"1. Random";882;405;91;314;510;490
"5288";"6. Biased  coin";"6. Biased  coin";882;422;99;323;501;499
"5289";"2. Neyman known";"2. Neyman known";882;421;86;335;466;534
"5290";"3. RSIHR Known";"3. RSIHR Known";882;470;59;411;356;644
"5291";"4. Rosenberger known";"4. Rosenberger known";882;566;27;539;150;850
"5292";"5. Optimal adjusted";"5. Optimal adjusted";882;408;93;315;519;481
"5293";"1. Random";"1. Random";883;411;95;316;497;503
"5294";"6. Biased  coin";"6. Biased  coin";883;397;91;306;501;499
"5295";"2. Neyman known";"2. Neyman known";883;460;83;377;422;578
"5296";"3. RSIHR Known";"3. RSIHR Known";883;468;68;400;356;644
"5297";"4. Rosenberger known";"4. Rosenberger known";883;580;32;548;143;857
"5298";"5. Optimal adjusted";"5. Optimal adjusted";883;421;103;318;515;485
"5299";"1. Random";"1. Random";884;395;93;302;488;512
"5300";"6. Biased  coin";"6. Biased  coin";884;408;105;303;501;499
"5301";"2. Neyman known";"2. Neyman known";884;428;91;337;445;555
"5302";"3. RSIHR Known";"3. RSIHR Known";884;450;83;367;379;621
"5303";"4. Rosenberger known";"4. Rosenberger known";884;530;30;500;148;852
"5304";"5. Optimal adjusted";"5. Optimal adjusted";884;369;102;267;537;463
"5305";"1. Random";"1. Random";885;409;113;296;524;476
"5306";"6. Biased  coin";"6. Biased  coin";885;380;89;291;500;501
"5307";"2. Neyman known";"2. Neyman known";885;433;107;326;479;521
"5308";"3. RSIHR Known";"3. RSIHR Known";885;466;77;389;368;632
"5309";"4. Rosenberger known";"4. Rosenberger known";885;554;38;516;163;837
"5310";"5. Optimal adjusted";"5. Optimal adjusted";885;403;111;292;527;473
"5311";"1. Random";"1. Random";886;404;102;302;510;490
"5312";"6. Biased  coin";"6. Biased  coin";886;412;105;307;502;499
"5313";"2. Neyman known";"2. Neyman known";886;428;83;345;444;556
"5314";"3. RSIHR Known";"3. RSIHR Known";886;455;75;380;375;625
"5315";"4. Rosenberger known";"4. Rosenberger known";886;553;33;520;157;843
"5316";"5. Optimal adjusted";"5. Optimal adjusted";886;389;93;296;527;473
"5317";"1. Random";"1. Random";887;393;99;294;500;500
"5318";"6. Biased  coin";"6. Biased  coin";887;398;104;294;501;500
"5319";"2. Neyman known";"2. Neyman known";887;414;82;332;464;536
"5320";"3. RSIHR Known";"3. RSIHR Known";887;460;58;402;343;657
"5321";"4. Rosenberger known";"4. Rosenberger known";887;548;27;521;149;851
"5322";"5. Optimal adjusted";"5. Optimal adjusted";887;387;109;278;543;457
"5323";"1. Random";"1. Random";888;391;99;292;505;495
"5324";"6. Biased  coin";"6. Biased  coin";888;412;100;312;501;499
"5325";"2. Neyman known";"2. Neyman known";888;427;92;335;442;558
"5326";"3. RSIHR Known";"3. RSIHR Known";888;446;67;379;378;622
"5327";"4. Rosenberger known";"4. Rosenberger known";888;554;28;526;144;856
"5328";"5. Optimal adjusted";"5. Optimal adjusted";888;397;117;280;541;459
"5329";"1. Random";"1. Random";889;402;106;296;520;480
"5330";"6. Biased  coin";"6. Biased  coin";889;410;96;314;500;500
"5331";"2. Neyman known";"2. Neyman known";889;458;82;376;410;590
"5332";"3. RSIHR Known";"3. RSIHR Known";889;480;79;401;356;644
"5333";"4. Rosenberger known";"4. Rosenberger known";889;576;31;545;136;864
"5334";"5. Optimal adjusted";"5. Optimal adjusted";889;405;107;298;528;472
"5335";"1. Random";"1. Random";890;375;91;284;504;496
"5336";"6. Biased  coin";"6. Biased  coin";890;386;95;291;500;500
"5337";"2. Neyman known";"2. Neyman known";890;376;85;291;481;519
"5338";"3. RSIHR Known";"3. RSIHR Known";890;415;70;345;379;621
"5339";"4. Rosenberger known";"4. Rosenberger known";890;506;29;477;133;867
"5340";"5. Optimal adjusted";"5. Optimal adjusted";890;356;106;250;545;455
"5341";"1. Random";"1. Random";891;367;76;291;484;516
"5342";"6. Biased  coin";"6. Biased  coin";891;378;83;295;500;500
"5343";"2. Neyman known";"2. Neyman known";891;426;83;343;437;563
"5344";"3. RSIHR Known";"3. RSIHR Known";891;441;65;376;365;635
"5345";"4. Rosenberger known";"4. Rosenberger known";891;533;29;504;144;856
"5346";"5. Optimal adjusted";"5. Optimal adjusted";891;339;90;249;541;459
"5347";"1. Random";"1. Random";892;391;119;272;530;470
"5348";"6. Biased  coin";"6. Biased  coin";892;413;111;302;499;501
"5349";"2. Neyman known";"2. Neyman known";892;408;90;318;449;551
"5350";"3. RSIHR Known";"3. RSIHR Known";892;465;94;371;386;614
"5351";"4. Rosenberger known";"4. Rosenberger known";892;539;27;512;158;842
"5352";"5. Optimal adjusted";"5. Optimal adjusted";892;379;99;280;528;472
"5353";"1. Random";"1. Random";893;397;89;308;484;516
"5354";"6. Biased  coin";"6. Biased  coin";893;385;100;285;500;500
"5355";"2. Neyman known";"2. Neyman known";893;424;95;329;445;555
"5356";"3. RSIHR Known";"3. RSIHR Known";893;437;60;377;356;644
"5357";"4. Rosenberger known";"4. Rosenberger known";893;530;23;507;138;862
"5358";"5. Optimal adjusted";"5. Optimal adjusted";893;349;91;258;528;472
"5359";"1. Random";"1. Random";894;434;118;316;495;505
"5360";"6. Biased  coin";"6. Biased  coin";894;404;97;307;502;498
"5361";"2. Neyman known";"2. Neyman known";894;427;95;332;459;541
"5362";"3. RSIHR Known";"3. RSIHR Known";894;461;74;387;370;630
"5363";"4. Rosenberger known";"4. Rosenberger known";894;564;36;528;155;845
"5364";"5. Optimal adjusted";"5. Optimal adjusted";894;396;116;280;540;460
"5365";"1. Random";"1. Random";895;383;113;270;550;450
"5366";"6. Biased  coin";"6. Biased  coin";895;393;97;296;501;500
"5367";"2. Neyman known";"2. Neyman known";895;417;89;328;437;563
"5368";"3. RSIHR Known";"3. RSIHR Known";895;449;71;378;387;613
"5369";"4. Rosenberger known";"4. Rosenberger known";895;513;21;492;149;851
"5370";"5. Optimal adjusted";"5. Optimal adjusted";895;375;94;281;530;470
"5371";"1. Random";"1. Random";896;380;99;281;489;511
"5372";"6. Biased  coin";"6. Biased  coin";896;395;106;289;500;500
"5373";"2. Neyman known";"2. Neyman known";896;400;77;323;441;559
"5374";"3. RSIHR Known";"3. RSIHR Known";896;433;89;344;390;610
"5375";"4. Rosenberger known";"4. Rosenberger known";896;514;26;488;139;861
"5376";"5. Optimal adjusted";"5. Optimal adjusted";896;379;120;259;551;449
"5377";"1. Random";"1. Random";897;402;107;295;504;496
"5378";"6. Biased  coin";"6. Biased  coin";897;379;91;288;501;499
"5379";"2. Neyman known";"2. Neyman known";897;421;94;327;458;542
"5380";"3. RSIHR Known";"3. RSIHR Known";897;439;76;363;400;600
"5381";"4. Rosenberger known";"4. Rosenberger known";897;560;34;526;142;858
"5382";"5. Optimal adjusted";"5. Optimal adjusted";897;379;116;263;554;446
"5383";"1. Random";"1. Random";898;418;97;321;488;512
"5384";"6. Biased  coin";"6. Biased  coin";898;382;83;299;500;501
"5385";"2. Neyman known";"2. Neyman known";898;422;80;342;458;542
"5386";"3. RSIHR Known";"3. RSIHR Known";898;442;57;385;372;628
"5387";"4. Rosenberger known";"4. Rosenberger known";898;541;21;520;147;853
"5388";"5. Optimal adjusted";"5. Optimal adjusted";898;381;92;289;532;468
"5389";"1. Random";"1. Random";899;416;101;315;511;489
"5390";"6. Biased  coin";"6. Biased  coin";899;405;94;311;503;499
"5391";"2. Neyman known";"2. Neyman known";899;420;89;331;461;539
"5392";"3. RSIHR Known";"3. RSIHR Known";899;475;78;397;374;626
"5393";"4. Rosenberger known";"4. Rosenberger known";899;563;29;534;146;854
"5394";"5. Optimal adjusted";"5. Optimal adjusted";899;396;106;290;540;460
"5395";"1. Random";"1. Random";900;411;123;288;533;467
"5396";"6. Biased  coin";"6. Biased  coin";900;415;103;312;498;502
"5397";"2. Neyman known";"2. Neyman known";900;437;96;341;439;561
"5398";"3. RSIHR Known";"3. RSIHR Known";900;468;81;387;371;629
"5399";"4. Rosenberger known";"4. Rosenberger known";900;569;35;534;147;853
"5400";"5. Optimal adjusted";"5. Optimal adjusted";900;386;111;275;542;458
"5401";"1. Random";"1. Random";901;390;86;304;482;518
"5402";"6. Biased  coin";"6. Biased  coin";901;395;92;303;502;498
"5403";"2. Neyman known";"2. Neyman known";901;419;91;328;456;544
"5404";"3. RSIHR Known";"3. RSIHR Known";901;442;76;366;375;625
"5405";"4. Rosenberger known";"4. Rosenberger known";901;549;29;520;134;866
"5406";"5. Optimal adjusted";"5. Optimal adjusted";901;380;97;283;527;473
"5407";"1. Random";"1. Random";902;372;82;290;504;496
"5408";"6. Biased  coin";"6. Biased  coin";902;390;87;303;500;502
"5409";"2. Neyman known";"2. Neyman known";902;424;91;333;459;541
"5410";"3. RSIHR Known";"3. RSIHR Known";902;427;52;375;365;635
"5411";"4. Rosenberger known";"4. Rosenberger known";902;527;17;510;149;851
"5412";"5. Optimal adjusted";"5. Optimal adjusted";902;375;90;285;525;475
"5413";"1. Random";"1. Random";903;387;100;287;524;476
"5414";"6. Biased  coin";"6. Biased  coin";903;402;97;305;500;501
"5415";"2. Neyman known";"2. Neyman known";903;408;87;321;467;533
"5416";"3. RSIHR Known";"3. RSIHR Known";903;476;69;407;364;636
"5417";"4. Rosenberger known";"4. Rosenberger known";903;548;29;519;144;856
"5418";"5. Optimal adjusted";"5. Optimal adjusted";903;412;103;309;510;490
"5419";"1. Random";"1. Random";904;420;110;310;491;509
"5420";"6. Biased  coin";"6. Biased  coin";904;392;105;287;502;499
"5421";"2. Neyman known";"2. Neyman known";904;444;97;347;441;559
"5422";"3. RSIHR Known";"3. RSIHR Known";904;467;71;396;347;653
"5423";"4. Rosenberger known";"4. Rosenberger known";904;540;21;519;130;870
"5424";"5. Optimal adjusted";"5. Optimal adjusted";904;399;127;272;530;470
"5425";"1. Random";"1. Random";905;393;90;303;506;494
"5426";"6. Biased  coin";"6. Biased  coin";905;380;90;290;501;499
"5427";"2. Neyman known";"2. Neyman known";905;418;80;338;439;561
"5428";"3. RSIHR Known";"3. RSIHR Known";905;433;52;381;376;624
"5429";"4. Rosenberger known";"4. Rosenberger known";905;543;22;521;144;856
"5430";"5. Optimal adjusted";"5. Optimal adjusted";905;375;91;284;529;471
"5431";"1. Random";"1. Random";906;381;100;281;516;484
"5432";"6. Biased  coin";"6. Biased  coin";906;395;102;293;501;499
"5433";"2. Neyman known";"2. Neyman known";906;406;88;318;460;540
"5434";"3. RSIHR Known";"3. RSIHR Known";906;468;75;393;345;655
"5435";"4. Rosenberger known";"4. Rosenberger known";906;528;37;491;164;836
"5436";"5. Optimal adjusted";"5. Optimal adjusted";906;350;100;250;552;448
"5437";"1. Random";"1. Random";907;381;111;270;513;487
"5438";"6. Biased  coin";"6. Biased  coin";907;408;110;298;500;501
"5439";"2. Neyman known";"2. Neyman known";907;403;93;310;458;542
"5440";"3. RSIHR Known";"3. RSIHR Known";907;431;83;348;388;612
"5441";"4. Rosenberger known";"4. Rosenberger known";907;517;28;489;145;855
"5442";"5. Optimal adjusted";"5. Optimal adjusted";907;398;122;276;534;466
"5443";"1. Random";"1. Random";908;412;94;318;498;502
"5444";"6. Biased  coin";"6. Biased  coin";908;399;105;294;499;501
"5445";"2. Neyman known";"2. Neyman known";908;423;92;331;442;558
"5446";"3. RSIHR Known";"3. RSIHR Known";908;451;57;394;325;675
"5447";"4. Rosenberger known";"4. Rosenberger known";908;538;31;507;141;859
"5448";"5. Optimal adjusted";"5. Optimal adjusted";908;376;106;270;546;454
"5449";"1. Random";"1. Random";909;381;92;289;497;503
"5450";"6. Biased  coin";"6. Biased  coin";909;387;100;287;501;499
"5451";"2. Neyman known";"2. Neyman known";909;403;81;322;445;555
"5452";"3. RSIHR Known";"3. RSIHR Known";909;435;60;375;359;641
"5453";"4. Rosenberger known";"4. Rosenberger known";909;522;20;502;136;864
"5454";"5. Optimal adjusted";"5. Optimal adjusted";909;386;101;285;523;477
"5455";"1. Random";"1. Random";910;390;105;285;536;464
"5456";"6. Biased  coin";"6. Biased  coin";910;402;99;303;502;499
"5457";"2. Neyman known";"2. Neyman known";910;443;89;354;429;571
"5458";"3. RSIHR Known";"3. RSIHR Known";910;477;69;408;347;653
"5459";"4. Rosenberger known";"4. Rosenberger known";910;555;20;535;146;854
"5460";"5. Optimal adjusted";"5. Optimal adjusted";910;377;102;275;545;455
"5461";"1. Random";"1. Random";911;395;89;306;478;522
"5462";"6. Biased  coin";"6. Biased  coin";911;390;95;295;504;496
"5463";"2. Neyman known";"2. Neyman known";911;426;89;337;466;534
"5464";"3. RSIHR Known";"3. RSIHR Known";911;470;78;392;368;632
"5465";"4. Rosenberger known";"4. Rosenberger known";911;554;32;522;158;842
"5466";"5. Optimal adjusted";"5. Optimal adjusted";911;370;104;266;558;442
"5467";"1. Random";"1. Random";912;412;84;328;468;532
"5468";"6. Biased  coin";"6. Biased  coin";912;402;89;313;500;502
"5469";"2. Neyman known";"2. Neyman known";912;419;85;334;442;558
"5470";"3. RSIHR Known";"3. RSIHR Known";912;442;66;376;377;623
"5471";"4. Rosenberger known";"4. Rosenberger known";912;559;17;542;122;878
"5472";"5. Optimal adjusted";"5. Optimal adjusted";912;363;94;269;548;452
"5473";"1. Random";"1. Random";913;388;85;303;499;501
"5474";"6. Biased  coin";"6. Biased  coin";913;394;93;301;499;501
"5475";"2. Neyman known";"2. Neyman known";913;409;89;320;455;545
"5476";"3. RSIHR Known";"3. RSIHR Known";913;458;64;394;339;661
"5477";"4. Rosenberger known";"4. Rosenberger known";913;536;22;514;127;873
"5478";"5. Optimal adjusted";"5. Optimal adjusted";913;370;99;271;514;486
"5479";"1. Random";"1. Random";914;400;93;307;504;496
"5480";"6. Biased  coin";"6. Biased  coin";914;409;93;316;502;501
"5481";"2. Neyman known";"2. Neyman known";914;441;90;351;453;547
"5482";"3. RSIHR Known";"3. RSIHR Known";914;459;66;393;363;637
"5483";"4. Rosenberger known";"4. Rosenberger known";914;562;26;536;142;858
"5484";"5. Optimal adjusted";"5. Optimal adjusted";914;385;98;287;525;475
"5485";"1. Random";"1. Random";915;383;109;274;523;477
"5486";"6. Biased  coin";"6. Biased  coin";915;386;110;276;501;499
"5487";"2. Neyman known";"2. Neyman known";915;423;93;330;459;541
"5488";"3. RSIHR Known";"3. RSIHR Known";915;454;79;375;361;639
"5489";"4. Rosenberger known";"4. Rosenberger known";915;551;31;520;121;879
"5490";"5. Optimal adjusted";"5. Optimal adjusted";915;385;135;250;585;415
"5491";"1. Random";"1. Random";916;400;101;299;531;469
"5492";"6. Biased  coin";"6. Biased  coin";916;397;100;297;499;501
"5493";"2. Neyman known";"2. Neyman known";916;424;101;323;476;524
"5494";"3. RSIHR Known";"3. RSIHR Known";916;437;75;362;367;633
"5495";"4. Rosenberger known";"4. Rosenberger known";916;528;27;501;156;844
"5496";"5. Optimal adjusted";"5. Optimal adjusted";916;374;103;271;546;454
"5497";"1. Random";"1. Random";917;368;81;287;495;505
"5498";"6. Biased  coin";"6. Biased  coin";917;399;100;299;501;500
"5499";"2. Neyman known";"2. Neyman known";917;424;85;339;427;573
"5500";"3. RSIHR Known";"3. RSIHR Known";917;438;65;373;380;620
"5501";"4. Rosenberger known";"4. Rosenberger known";917;535;19;516;127;873
"5502";"5. Optimal adjusted";"5. Optimal adjusted";917;355;93;262;544;456
"5503";"1. Random";"1. Random";918;417;102;315;493;507
"5504";"6. Biased  coin";"6. Biased  coin";918;401;96;305;502;499
"5505";"2. Neyman known";"2. Neyman known";918;399;74;325;456;544
"5506";"3. RSIHR Known";"3. RSIHR Known";918;451;74;377;369;631
"5507";"4. Rosenberger known";"4. Rosenberger known";918;549;29;520;141;859
"5508";"5. Optimal adjusted";"5. Optimal adjusted";918;398;106;292;531;469
"5509";"1. Random";"1. Random";919;375;87;288;516;484
"5510";"6. Biased  coin";"6. Biased  coin";919;384;90;294;500;500
"5511";"2. Neyman known";"2. Neyman known";919;411;81;330;444;556
"5512";"3. RSIHR Known";"3. RSIHR Known";919;458;80;378;371;629
"5513";"4. Rosenberger known";"4. Rosenberger known";919;515;18;497;146;854
"5514";"5. Optimal adjusted";"5. Optimal adjusted";919;373;103;270;552;448
"5515";"1. Random";"1. Random";920;411;99;312;521;479
"5516";"6. Biased  coin";"6. Biased  coin";920;408;94;314;501;500
"5517";"2. Neyman known";"2. Neyman known";920;446;87;359;455;545
"5518";"3. RSIHR Known";"3. RSIHR Known";920;474;56;418;359;641
"5519";"4. Rosenberger known";"4. Rosenberger known";920;570;29;541;142;858
"5520";"5. Optimal adjusted";"5. Optimal adjusted";920;409;119;290;561;439
"5521";"1. Random";"1. Random";921;391;96;295;510;490
"5522";"6. Biased  coin";"6. Biased  coin";921;426;110;316;498;502
"5523";"2. Neyman known";"2. Neyman known";921;441;94;347;443;557
"5524";"3. RSIHR Known";"3. RSIHR Known";921;477;60;417;345;655
"5525";"4. Rosenberger known";"4. Rosenberger known";921;561;19;542;128;872
"5526";"5. Optimal adjusted";"5. Optimal adjusted";921;388;95;293;536;464
"5527";"1. Random";"1. Random";922;396;106;290;510;490
"5528";"6. Biased  coin";"6. Biased  coin";922;407;112;295;504;501
"5529";"2. Neyman known";"2. Neyman known";922;406;93;313;454;546
"5530";"3. RSIHR Known";"3. RSIHR Known";922;438;81;357;392;608
"5531";"4. Rosenberger known";"4. Rosenberger known";922;524;30;494;135;865
"5532";"5. Optimal adjusted";"5. Optimal adjusted";922;382;124;258;549;451
"5533";"1. Random";"1. Random";923;416;101;315;505;495
"5534";"6. Biased  coin";"6. Biased  coin";923;402;96;306;501;500
"5535";"2. Neyman known";"2. Neyman known";923;409;82;327;443;557
"5536";"3. RSIHR Known";"3. RSIHR Known";923;455;79;376;367;633
"5537";"4. Rosenberger known";"4. Rosenberger known";923;533;31;502;146;854
"5538";"5. Optimal adjusted";"5. Optimal adjusted";923;381;105;276;524;476
"5539";"1. Random";"1. Random";924;407;107;300;501;499
"5540";"6. Biased  coin";"6. Biased  coin";924;426;115;311;501;500
"5541";"2. Neyman known";"2. Neyman known";924;443;93;350;443;557
"5542";"3. RSIHR Known";"3. RSIHR Known";924;446;65;381;365;635
"5543";"4. Rosenberger known";"4. Rosenberger known";924;542;35;507;167;833
"5544";"5. Optimal adjusted";"5. Optimal adjusted";924;396;109;287;542;458
"5545";"1. Random";"1. Random";925;405;107;298;502;498
"5546";"6. Biased  coin";"6. Biased  coin";925;398;102;296;502;498
"5547";"2. Neyman known";"2. Neyman known";925;436;100;336;445;555
"5548";"3. RSIHR Known";"3. RSIHR Known";925;475;67;408;345;655
"5549";"4. Rosenberger known";"4. Rosenberger known";925;553;26;527;145;855
"5550";"5. Optimal adjusted";"5. Optimal adjusted";925;410;111;299;532;468
"5551";"1. Random";"1. Random";926;394;80;314;464;536
"5552";"6. Biased  coin";"6. Biased  coin";926;378;89;289;500;500
"5553";"2. Neyman known";"2. Neyman known";926;404;74;330;432;568
"5554";"3. RSIHR Known";"3. RSIHR Known";926;417;67;350;377;623
"5555";"4. Rosenberger known";"4. Rosenberger known";926;537;36;501;148;852
"5556";"5. Optimal adjusted";"5. Optimal adjusted";926;366;99;267;543;457
"5557";"1. Random";"1. Random";927;389;93;296;506;494
"5558";"6. Biased  coin";"6. Biased  coin";927;399;103;296;499;501
"5559";"2. Neyman known";"2. Neyman known";927;410;85;325;467;533
"5560";"3. RSIHR Known";"3. RSIHR Known";927;482;77;405;362;638
"5561";"4. Rosenberger known";"4. Rosenberger known";927;551;38;513;159;841
"5562";"5. Optimal adjusted";"5. Optimal adjusted";927;408;96;312;505;495
"5563";"1. Random";"1. Random";928;391;91;300;476;524
"5564";"6. Biased  coin";"6. Biased  coin";928;398;98;300;500;500
"5565";"2. Neyman known";"2. Neyman known";928;429;79;350;432;568
"5566";"3. RSIHR Known";"3. RSIHR Known";928;465;65;400;343;657
"5567";"4. Rosenberger known";"4. Rosenberger known";928;550;35;515;145;855
"5568";"5. Optimal adjusted";"5. Optimal adjusted";928;378;100;278;524;476
"5569";"1. Random";"1. Random";929;420;116;304;502;498
"5570";"6. Biased  coin";"6. Biased  coin";929;411;92;319;500;501
"5571";"2. Neyman known";"2. Neyman known";929;430;93;337;456;544
"5572";"3. RSIHR Known";"3. RSIHR Known";929;475;84;391;380;620
"5573";"4. Rosenberger known";"4. Rosenberger known";929;567;24;543;130;870
"5574";"5. Optimal adjusted";"5. Optimal adjusted";929;372;100;272;546;454
"5575";"1. Random";"1. Random";930;410;108;302;518;482
"5576";"6. Biased  coin";"6. Biased  coin";930;395;90;305;500;500
"5577";"2. Neyman known";"2. Neyman known";930;425;85;340;459;541
"5578";"3. RSIHR Known";"3. RSIHR Known";930;476;74;402;370;630
"5579";"4. Rosenberger known";"4. Rosenberger known";930;543;26;517;149;851
"5580";"5. Optimal adjusted";"5. Optimal adjusted";930;396;105;291;527;473
"5581";"1. Random";"1. Random";931;379;98;281;515;485
"5582";"6. Biased  coin";"6. Biased  coin";931;386;95;291;502;501
"5583";"2. Neyman known";"2. Neyman known";931;414;78;336;431;569
"5584";"3. RSIHR Known";"3. RSIHR Known";931;459;76;383;357;643
"5585";"4. Rosenberger known";"4. Rosenberger known";931;535;28;507;142;858
"5586";"5. Optimal adjusted";"5. Optimal adjusted";931;375;98;277;519;481
"5587";"1. Random";"1. Random";932;419;87;332;448;552
"5588";"6. Biased  coin";"6. Biased  coin";932;404;102;302;500;500
"5589";"2. Neyman known";"2. Neyman known";932;427;90;337;440;560
"5590";"3. RSIHR Known";"3. RSIHR Known";932;431;61;370;350;650
"5591";"4. Rosenberger known";"4. Rosenberger known";932;541;32;509;146;854
"5592";"5. Optimal adjusted";"5. Optimal adjusted";932;390;110;280;539;461
"5593";"1. Random";"1. Random";933;394;91;303;508;492
"5594";"6. Biased  coin";"6. Biased  coin";933;421;109;312;500;500
"5595";"2. Neyman known";"2. Neyman known";933;449;101;348;453;547
"5596";"3. RSIHR Known";"3. RSIHR Known";933;480;82;398;370;630
"5597";"4. Rosenberger known";"4. Rosenberger known";933;562;32;530;149;851
"5598";"5. Optimal adjusted";"5. Optimal adjusted";933;394;121;273;554;446
"5599";"1. Random";"1. Random";934;416;95;321;491;509
"5600";"6. Biased  coin";"6. Biased  coin";934;400;102;298;504;497
"5601";"2. Neyman known";"2. Neyman known";934;434;96;338;431;569
"5602";"3. RSIHR Known";"3. RSIHR Known";934;442;67;375;371;629
"5603";"4. Rosenberger known";"4. Rosenberger known";934;557;26;531;134;866
"5604";"5. Optimal adjusted";"5. Optimal adjusted";934;372;96;276;534;466
"5605";"1. Random";"1. Random";935;425;112;313;494;506
"5606";"6. Biased  coin";"6. Biased  coin";935;403;102;301;505;497
"5607";"2. Neyman known";"2. Neyman known";935;430;91;339;462;538
"5608";"3. RSIHR Known";"3. RSIHR Known";935;438;69;369;353;647
"5609";"4. Rosenberger known";"4. Rosenberger known";935;538;24;514;143;857
"5610";"5. Optimal adjusted";"5. Optimal adjusted";935;378;110;268;538;462
"5611";"1. Random";"1. Random";936;406;97;309;473;527
"5612";"6. Biased  coin";"6. Biased  coin";936;406;106;300;501;499
"5613";"2. Neyman known";"2. Neyman known";936;423;91;332;458;542
"5614";"3. RSIHR Known";"3. RSIHR Known";936;450;77;373;387;613
"5615";"4. Rosenberger known";"4. Rosenberger known";936;544;37;507;149;851
"5616";"5. Optimal adjusted";"5. Optimal adjusted";936;361;100;261;551;449
"5617";"1. Random";"1. Random";937;398;112;286;523;477
"5618";"6. Biased  coin";"6. Biased  coin";937;423;115;308;501;500
"5619";"2. Neyman known";"2. Neyman known";937;437;102;335;433;567
"5620";"3. RSIHR Known";"3. RSIHR Known";937;461;83;378;372;628
"5621";"4. Rosenberger known";"4. Rosenberger known";937;555;38;517;148;852
"5622";"5. Optimal adjusted";"5. Optimal adjusted";937;417;124;293;532;468
"5623";"1. Random";"1. Random";938;403;86;317;469;531
"5624";"6. Biased  coin";"6. Biased  coin";938;384;95;289;500;500
"5625";"2. Neyman known";"2. Neyman known";938;426;91;335;448;552
"5626";"3. RSIHR Known";"3. RSIHR Known";938;447;74;373;364;636
"5627";"4. Rosenberger known";"4. Rosenberger known";938;542;35;507;143;857
"5628";"5. Optimal adjusted";"5. Optimal adjusted";938;411;111;300;518;482
"5629";"1. Random";"1. Random";939;390;90;300;512;488
"5630";"6. Biased  coin";"6. Biased  coin";939;368;84;284;501;500
"5631";"2. Neyman known";"2. Neyman known";939;439;80;359;445;555
"5632";"3. RSIHR Known";"3. RSIHR Known";939;458;74;384;361;639
"5633";"4. Rosenberger known";"4. Rosenberger known";939;542;27;515;135;865
"5634";"5. Optimal adjusted";"5. Optimal adjusted";939;376;91;285;525;475
"5635";"1. Random";"1. Random";940;384;105;279;518;482
"5636";"6. Biased  coin";"6. Biased  coin";940;382;99;283;500;500
"5637";"2. Neyman known";"2. Neyman known";940;408;99;309;461;539
"5638";"3. RSIHR Known";"3. RSIHR Known";940;448;67;381;352;648
"5639";"4. Rosenberger known";"4. Rosenberger known";940;518;40;478;177;823
"5640";"5. Optimal adjusted";"5. Optimal adjusted";940;390;128;262;550;450
"5641";"1. Random";"1. Random";941;412;117;295;506;494
"5642";"6. Biased  coin";"6. Biased  coin";941;394;104;290;502;500
"5643";"2. Neyman known";"2. Neyman known";941;425;93;332;455;545
"5644";"3. RSIHR Known";"3. RSIHR Known";941;433;70;363;377;623
"5645";"4. Rosenberger known";"4. Rosenberger known";941;528;30;498;152;848
"5646";"5. Optimal adjusted";"5. Optimal adjusted";941;376;119;257;570;430
"5647";"1. Random";"1. Random";942;402;99;303;486;514
"5648";"6. Biased  coin";"6. Biased  coin";942;431;110;321;499;502
"5649";"2. Neyman known";"2. Neyman known";942;447;90;357;427;573
"5650";"3. RSIHR Known";"3. RSIHR Known";942;450;68;382;380;620
"5651";"4. Rosenberger known";"4. Rosenberger known";942;577;31;546;134;866
"5652";"5. Optimal adjusted";"5. Optimal adjusted";942;387;101;286;539;461
"5653";"1. Random";"1. Random";943;410;113;297;521;479
"5654";"6. Biased  coin";"6. Biased  coin";943;409;112;297;499;501
"5655";"2. Neyman known";"2. Neyman known";943;415;91;324;464;536
"5656";"3. RSIHR Known";"3. RSIHR Known";943;450;83;367;374;626
"5657";"4. Rosenberger known";"4. Rosenberger known";943;529;26;503;139;861
"5658";"5. Optimal adjusted";"5. Optimal adjusted";943;395;119;276;547;453
"5659";"1. Random";"1. Random";944;427;115;312;500;500
"5660";"6. Biased  coin";"6. Biased  coin";944;420;104;316;499;501
"5661";"2. Neyman known";"2. Neyman known";944;411;89;322;464;536
"5662";"3. RSIHR Known";"3. RSIHR Known";944;449;77;372;368;632
"5663";"4. Rosenberger known";"4. Rosenberger known";944;555;32;523;138;862
"5664";"5. Optimal adjusted";"5. Optimal adjusted";944;381;100;281;550;450
"5665";"1. Random";"1. Random";945;403;93;310;485;515
"5666";"6. Biased  coin";"6. Biased  coin";945;417;110;307;501;499
"5667";"2. Neyman known";"2. Neyman known";945;405;87;318;448;552
"5668";"3. RSIHR Known";"3. RSIHR Known";945;459;85;374;381;619
"5669";"4. Rosenberger known";"4. Rosenberger known";945;543;25;518;141;859
"5670";"5. Optimal adjusted";"5. Optimal adjusted";945;373;85;288;526;474
"5671";"1. Random";"1. Random";946;394;108;286;524;476
"5672";"6. Biased  coin";"6. Biased  coin";946;409;109;300;500;500
"5673";"2. Neyman known";"2. Neyman known";946;429;102;327;465;535
"5674";"3. RSIHR Known";"3. RSIHR Known";946;450;70;380;355;645
"5675";"4. Rosenberger known";"4. Rosenberger known";946;531;32;499;157;843
"5676";"5. Optimal adjusted";"5. Optimal adjusted";946;381;105;276;529;471
"5677";"1. Random";"1. Random";947;419;93;326;482;518
"5678";"6. Biased  coin";"6. Biased  coin";947;397;95;302;501;500
"5679";"2. Neyman known";"2. Neyman known";947;440;81;359;419;581
"5680";"3. RSIHR Known";"3. RSIHR Known";947;463;83;380;363;637
"5681";"4. Rosenberger known";"4. Rosenberger known";947;563;20;543;121;879
"5682";"5. Optimal adjusted";"5. Optimal adjusted";947;386;115;271;540;460
"5683";"1. Random";"1. Random";948;392;85;307;487;513
"5684";"6. Biased  coin";"6. Biased  coin";948;403;94;309;501;501
"5685";"2. Neyman known";"2. Neyman known";948;437;76;361;424;576
"5686";"3. RSIHR Known";"3. RSIHR Known";948;465;82;383;376;624
"5687";"4. Rosenberger known";"4. Rosenberger known";948;556;32;524;133;867
"5688";"5. Optimal adjusted";"5. Optimal adjusted";948;373;101;272;537;463
"5689";"1. Random";"1. Random";949;420;105;315;497;503
"5690";"6. Biased  coin";"6. Biased  coin";949;392;87;305;504;499
"5691";"2. Neyman known";"2. Neyman known";949;434;78;356;406;594
"5692";"3. RSIHR Known";"3. RSIHR Known";949;449;59;390;359;641
"5693";"4. Rosenberger known";"4. Rosenberger known";949;557;24;533;124;876
"5694";"5. Optimal adjusted";"5. Optimal adjusted";949;382;102;280;537;463
"5695";"1. Random";"1. Random";950;400;98;302;491;509
"5696";"6. Biased  coin";"6. Biased  coin";950;404;89;315;503;500
"5697";"2. Neyman known";"2. Neyman known";950;450;86;364;437;563
"5698";"3. RSIHR Known";"3. RSIHR Known";950;461;69;392;350;650
"5699";"4. Rosenberger known";"4. Rosenberger known";950;554;35;519;171;829
"5700";"5. Optimal adjusted";"5. Optimal adjusted";950;395;95;300;520;480
"5701";"1. Random";"1. Random";951;387;99;288;520;480
"5702";"6. Biased  coin";"6. Biased  coin";951;399;105;294;504;500
"5703";"2. Neyman known";"2. Neyman known";951;435;101;334;455;545
"5704";"3. RSIHR Known";"3. RSIHR Known";951;449;77;372;380;620
"5705";"4. Rosenberger known";"4. Rosenberger known";951;548;36;512;146;854
"5706";"5. Optimal adjusted";"5. Optimal adjusted";951;365;108;257;557;443
"5707";"1. Random";"1. Random";952;392;96;296;507;493
"5708";"6. Biased  coin";"6. Biased  coin";952;402;95;307;502;500
"5709";"2. Neyman known";"2. Neyman known";952;407;80;327;437;563
"5710";"3. RSIHR Known";"3. RSIHR Known";952;439;59;380;341;659
"5711";"4. Rosenberger known";"4. Rosenberger known";952;519;27;492;163;837
"5712";"5. Optimal adjusted";"5. Optimal adjusted";952;361;102;259;542;458
"5713";"1. Random";"1. Random";953;395;98;297;506;494
"5714";"6. Biased  coin";"6. Biased  coin";953;406;123;283;503;498
"5715";"2. Neyman known";"2. Neyman known";953;415;98;317;460;540
"5716";"3. RSIHR Known";"3. RSIHR Known";953;425;78;347;397;603
"5717";"4. Rosenberger known";"4. Rosenberger known";953;538;40;498;170;830
"5718";"5. Optimal adjusted";"5. Optimal adjusted";953;379;101;278;508;492
"5719";"1. Random";"1. Random";954;392;92;300;497;503
"5720";"6. Biased  coin";"6. Biased  coin";954;413;111;302;502;499
"5721";"2. Neyman known";"2. Neyman known";954;419;89;330;457;543
"5722";"3. RSIHR Known";"3. RSIHR Known";954;471;80;391;352;648
"5723";"4. Rosenberger known";"4. Rosenberger known";954;548;30;518;152;848
"5724";"5. Optimal adjusted";"5. Optimal adjusted";954;405;117;288;533;467
"5725";"1. Random";"1. Random";955;421;106;315;474;526
"5726";"6. Biased  coin";"6. Biased  coin";955;400;101;299;501;499
"5727";"2. Neyman known";"2. Neyman known";955;434;107;327;453;547
"5728";"3. RSIHR Known";"3. RSIHR Known";955;475;84;391;366;634
"5729";"4. Rosenberger known";"4. Rosenberger known";955;543;27;516;137;863
"5730";"5. Optimal adjusted";"5. Optimal adjusted";955;411;115;296;520;480
"5731";"1. Random";"1. Random";956;388;91;297;495;505
"5732";"6. Biased  coin";"6. Biased  coin";956;389;102;287;503;498
"5733";"2. Neyman known";"2. Neyman known";956;412;91;321;459;541
"5734";"3. RSIHR Known";"3. RSIHR Known";956;446;77;369;374;626
"5735";"4. Rosenberger known";"4. Rosenberger known";956;521;30;491;157;843
"5736";"5. Optimal adjusted";"5. Optimal adjusted";956;362;100;262;544;456
"5737";"1. Random";"1. Random";957;428;92;336;467;533
"5738";"6. Biased  coin";"6. Biased  coin";957;388;89;299;502;498
"5739";"2. Neyman known";"2. Neyman known";957;425;89;336;457;543
"5740";"3. RSIHR Known";"3. RSIHR Known";957;443;76;367;365;635
"5741";"4. Rosenberger known";"4. Rosenberger known";957;535;31;504;161;839
"5742";"5. Optimal adjusted";"5. Optimal adjusted";957;365;98;267;544;456
"5743";"1. Random";"1. Random";958;365;84;281;512;488
"5744";"6. Biased  coin";"6. Biased  coin";958;399;97;302;501;499
"5745";"2. Neyman known";"2. Neyman known";958;397;81;316;462;538
"5746";"3. RSIHR Known";"3. RSIHR Known";958;444;69;375;365;635
"5747";"4. Rosenberger known";"4. Rosenberger known";958;515;31;484;153;847
"5748";"5. Optimal adjusted";"5. Optimal adjusted";958;365;103;262;527;473
"5749";"1. Random";"1. Random";959;378;102;276;526;474
"5750";"6. Biased  coin";"6. Biased  coin";959;385;100;285;501;500
"5751";"2. Neyman known";"2. Neyman known";959;420;94;326;453;547
"5752";"3. RSIHR Known";"3. RSIHR Known";959;438;66;372;350;650
"5753";"4. Rosenberger known";"4. Rosenberger known";959;555;24;531;115;885
"5754";"5. Optimal adjusted";"5. Optimal adjusted";959;377;105;272;528;472
"5755";"1. Random";"1. Random";960;388;94;294;510;490
"5756";"6. Biased  coin";"6. Biased  coin";960;404;103;301;500;500
"5757";"2. Neyman known";"2. Neyman known";960;425;81;344;448;552
"5758";"3. RSIHR Known";"3. RSIHR Known";960;470;69;401;355;645
"5759";"4. Rosenberger known";"4. Rosenberger known";960;549;24;525;146;854
"5760";"5. Optimal adjusted";"5. Optimal adjusted";960;401;89;312;519;481
"5761";"1. Random";"1. Random";961;419;102;317;483;517
"5762";"6. Biased  coin";"6. Biased  coin";961;424;105;319;499;501
"5763";"2. Neyman known";"2. Neyman known";961;443;96;347;436;564
"5764";"3. RSIHR Known";"3. RSIHR Known";961;483;90;393;385;615
"5765";"4. Rosenberger known";"4. Rosenberger known";961;574;24;550;132;868
"5766";"5. Optimal adjusted";"5. Optimal adjusted";961;399;110;289;552;448
"5767";"1. Random";"1. Random";962;429;99;330;484;516
"5768";"6. Biased  coin";"6. Biased  coin";962;396;90;306;500;500
"5769";"2. Neyman known";"2. Neyman known";962;420;87;333;443;557
"5770";"3. RSIHR Known";"3. RSIHR Known";962;464;74;390;368;632
"5771";"4. Rosenberger known";"4. Rosenberger known";962;559;21;538;141;859
"5772";"5. Optimal adjusted";"5. Optimal adjusted";962;391;100;291;542;458
"5773";"1. Random";"1. Random";963;414;92;322;497;503
"5774";"6. Biased  coin";"6. Biased  coin";963;396;87;309;501;500
"5775";"2. Neyman known";"2. Neyman known";963;416;72;344;429;571
"5776";"3. RSIHR Known";"3. RSIHR Known";963;476;74;402;367;633
"5777";"4. Rosenberger known";"4. Rosenberger known";963;552;22;530;129;871
"5778";"5. Optimal adjusted";"5. Optimal adjusted";963;396;97;299;521;479
"5779";"1. Random";"1. Random";964;412;85;327;476;524
"5780";"6. Biased  coin";"6. Biased  coin";964;386;93;293;500;500
"5781";"2. Neyman known";"2. Neyman known";964;413;92;321;459;541
"5782";"3. RSIHR Known";"3. RSIHR Known";964;472;72;400;357;643
"5783";"4. Rosenberger known";"4. Rosenberger known";964;540;25;515;151;849
"5784";"5. Optimal adjusted";"5. Optimal adjusted";964;377;106;271;554;446
"5785";"1. Random";"1. Random";965;377;94;283;516;484
"5786";"6. Biased  coin";"6. Biased  coin";965;383;80;303;500;501
"5787";"2. Neyman known";"2. Neyman known";965;419;83;336;431;569
"5788";"3. RSIHR Known";"3. RSIHR Known";965;454;67;387;355;645
"5789";"4. Rosenberger known";"4. Rosenberger known";965;528;29;499;155;845
"5790";"5. Optimal adjusted";"5. Optimal adjusted";965;366;94;272;548;452
"5791";"1. Random";"1. Random";966;403;96;307;493;507
"5792";"6. Biased  coin";"6. Biased  coin";966;403;105;298;500;500
"5793";"2. Neyman known";"2. Neyman known";966;426;94;332;467;533
"5794";"3. RSIHR Known";"3. RSIHR Known";966;443;79;364;381;619
"5795";"4. Rosenberger known";"4. Rosenberger known";966;552;31;521;146;854
"5796";"5. Optimal adjusted";"5. Optimal adjusted";966;389;117;272;549;451
"5797";"1. Random";"1. Random";967;394;107;287;518;482
"5798";"6. Biased  coin";"6. Biased  coin";967;418;113;305;502;500
"5799";"2. Neyman known";"2. Neyman known";967;436;110;326;473;527
"5800";"3. RSIHR Known";"3. RSIHR Known";967;475;78;397;376;624
"5801";"4. Rosenberger known";"4. Rosenberger known";967;552;32;520;144;856
"5802";"5. Optimal adjusted";"5. Optimal adjusted";967;395;112;283;546;454
"5803";"1. Random";"1. Random";968;431;105;326;478;522
"5804";"6. Biased  coin";"6. Biased  coin";968;424;107;317;500;501
"5805";"2. Neyman known";"2. Neyman known";968;452;92;360;434;566
"5806";"3. RSIHR Known";"3. RSIHR Known";968;462;75;387;382;618
"5807";"4. Rosenberger known";"4. Rosenberger known";968;543;25;518;139;861
"5808";"5. Optimal adjusted";"5. Optimal adjusted";968;395;114;281;548;452
"5809";"1. Random";"1. Random";969;409;106;303;491;509
"5810";"6. Biased  coin";"6. Biased  coin";969;404;94;310;501;500
"5811";"2. Neyman known";"2. Neyman known";969;449;88;361;420;580
"5812";"3. RSIHR Known";"3. RSIHR Known";969;447;76;371;393;607
"5813";"4. Rosenberger known";"4. Rosenberger known";969;585;38;547;150;850
"5814";"5. Optimal adjusted";"5. Optimal adjusted";969;404;106;298;526;474
"5815";"1. Random";"1. Random";970;408;119;289;503;497
"5816";"6. Biased  coin";"6. Biased  coin";970;414;120;294;499;501
"5817";"2. Neyman known";"2. Neyman known";970;421;97;324;450;550
"5818";"3. RSIHR Known";"3. RSIHR Known";970;426;73;353;368;632
"5819";"4. Rosenberger known";"4. Rosenberger known";970;527;26;501;141;859
"5820";"5. Optimal adjusted";"5. Optimal adjusted";970;378;107;271;548;452
"5821";"1. Random";"1. Random";971;408;97;311;504;496
"5822";"6. Biased  coin";"6. Biased  coin";971;395;91;304;503;500
"5823";"2. Neyman known";"2. Neyman known";971;427;93;334;476;524
"5824";"3. RSIHR Known";"3. RSIHR Known";971;463;77;386;391;609
"5825";"4. Rosenberger known";"4. Rosenberger known";971;559;26;533;125;875
"5826";"5. Optimal adjusted";"5. Optimal adjusted";971;405;109;296;524;476
"5827";"1. Random";"1. Random";972;401;96;305;483;517
"5828";"6. Biased  coin";"6. Biased  coin";972;407;101;306;501;500
"5829";"2. Neyman known";"2. Neyman known";972;437;91;346;430;570
"5830";"3. RSIHR Known";"3. RSIHR Known";972;437;66;371;382;618
"5831";"4. Rosenberger known";"4. Rosenberger known";972;552;27;525;146;854
"5832";"5. Optimal adjusted";"5. Optimal adjusted";972;392;93;299;518;482
"5833";"1. Random";"1. Random";973;389;98;291;520;480
"5834";"6. Biased  coin";"6. Biased  coin";973;409;102;307;500;500
"5835";"2. Neyman known";"2. Neyman known";973;428;84;344;426;574
"5836";"3. RSIHR Known";"3. RSIHR Known";973;438;67;371;370;630
"5837";"4. Rosenberger known";"4. Rosenberger known";973;536;35;501;156;844
"5838";"5. Optimal adjusted";"5. Optimal adjusted";973;370;108;262;552;448
"5839";"1. Random";"1. Random";974;405;102;303;487;513
"5840";"6. Biased  coin";"6. Biased  coin";974;417;108;309;499;501
"5841";"2. Neyman known";"2. Neyman known";974;442;106;336;444;556
"5842";"3. RSIHR Known";"3. RSIHR Known";974;481;92;389;354;646
"5843";"4. Rosenberger known";"4. Rosenberger known";974;552;28;524;136;864
"5844";"5. Optimal adjusted";"5. Optimal adjusted";974;384;111;273;527;473
"5845";"1. Random";"1. Random";975;420;91;329;492;508
"5846";"6. Biased  coin";"6. Biased  coin";975;392;90;302;501;500
"5847";"2. Neyman known";"2. Neyman known";975;436;89;347;461;539
"5848";"3. RSIHR Known";"3. RSIHR Known";975;468;76;392;367;633
"5849";"4. Rosenberger known";"4. Rosenberger known";975;577;29;548;141;859
"5850";"5. Optimal adjusted";"5. Optimal adjusted";975;389;99;290;520;480
"5851";"1. Random";"1. Random";976;371;84;287;500;500
"5852";"6. Biased  coin";"6. Biased  coin";976;393;92;301;499;501
"5853";"2. Neyman known";"2. Neyman known";976;406;83;323;448;552
"5854";"3. RSIHR Known";"3. RSIHR Known";976;425;50;375;364;636
"5855";"4. Rosenberger known";"4. Rosenberger known";976;540;28;512;153;847
"5856";"5. Optimal adjusted";"5. Optimal adjusted";976;368;86;282;508;492
"5857";"1. Random";"1. Random";977;396;87;309;502;498
"5858";"6. Biased  coin";"6. Biased  coin";977;420;97;323;502;499
"5859";"2. Neyman known";"2. Neyman known";977;434;73;361;434;566
"5860";"3. RSIHR Known";"3. RSIHR Known";977;461;58;403;363;637
"5861";"4. Rosenberger known";"4. Rosenberger known";977;564;32;532;149;851
"5862";"5. Optimal adjusted";"5. Optimal adjusted";977;375;92;283;546;454
"5863";"1. Random";"1. Random";978;390;90;300;492;508
"5864";"6. Biased  coin";"6. Biased  coin";978;404;105;299;500;500
"5865";"2. Neyman known";"2. Neyman known";978;442;91;351;418;582
"5866";"3. RSIHR Known";"3. RSIHR Known";978;444;69;375;386;614
"5867";"4. Rosenberger known";"4. Rosenberger known";978;526;29;497;149;851
"5868";"5. Optimal adjusted";"5. Optimal adjusted";978;361;116;245;563;437
"5869";"1. Random";"1. Random";979;407;89;318;483;517
"5870";"6. Biased  coin";"6. Biased  coin";979;413;96;317;502;499
"5871";"2. Neyman known";"2. Neyman known";979;401;76;325;437;563
"5872";"3. RSIHR Known";"3. RSIHR Known";979;464;78;386;364;636
"5873";"4. Rosenberger known";"4. Rosenberger known";979;562;33;529;137;863
"5874";"5. Optimal adjusted";"5. Optimal adjusted";979;372;87;285;540;460
"5875";"1. Random";"1. Random";980;438;114;324;491;509
"5876";"6. Biased  coin";"6. Biased  coin";980;396;96;300;501;499
"5877";"2. Neyman known";"2. Neyman known";980;409;92;317;469;531
"5878";"3. RSIHR Known";"3. RSIHR Known";980;451;81;370;384;616
"5879";"4. Rosenberger known";"4. Rosenberger known";980;559;29;530;124;876
"5880";"5. Optimal adjusted";"5. Optimal adjusted";980;395;111;284;519;481
"5881";"1. Random";"1. Random";981;393;104;289;501;499
"5882";"6. Biased  coin";"6. Biased  coin";981;387;91;296;501;500
"5883";"2. Neyman known";"2. Neyman known";981;404;90;314;469;531
"5884";"3. RSIHR Known";"3. RSIHR Known";981;432;65;367;373;627
"5885";"4. Rosenberger known";"4. Rosenberger known";981;528;29;499;156;844
"5886";"5. Optimal adjusted";"5. Optimal adjusted";981;363;105;258;566;434
"5887";"1. Random";"1. Random";982;392;115;277;530;470
"5888";"6. Biased  coin";"6. Biased  coin";982;388;108;280;503;500
"5889";"2. Neyman known";"2. Neyman known";982;438;120;318;469;531
"5890";"3. RSIHR Known";"3. RSIHR Known";982;453;72;381;361;639
"5891";"4. Rosenberger known";"4. Rosenberger known";982;525;33;492;163;837
"5892";"5. Optimal adjusted";"5. Optimal adjusted";982;374;111;263;544;456
"5893";"1. Random";"1. Random";983;412;110;302;520;480
"5894";"6. Biased  coin";"6. Biased  coin";983;403;100;303;500;501
"5895";"2. Neyman known";"2. Neyman known";983;405;94;311;478;522
"5896";"3. RSIHR Known";"3. RSIHR Known";983;477;85;392;369;631
"5897";"4. Rosenberger known";"4. Rosenberger known";983;554;31;523;157;843
"5898";"5. Optimal adjusted";"5. Optimal adjusted";983;374;104;270;541;459
"5899";"1. Random";"1. Random";984;397;101;296;511;489
"5900";"6. Biased  coin";"6. Biased  coin";984;407;111;296;499;501
"5901";"2. Neyman known";"2. Neyman known";984;416;90;326;475;525
"5902";"3. RSIHR Known";"3. RSIHR Known";984;425;73;352;408;592
"5903";"4. Rosenberger known";"4. Rosenberger known";984;559;20;539;127;873
"5904";"5. Optimal adjusted";"5. Optimal adjusted";984;375;100;275;533;467
"5905";"1. Random";"1. Random";985;404;87;317;511;489
"5906";"6. Biased  coin";"6. Biased  coin";985;384;90;294;500;500
"5907";"2. Neyman known";"2. Neyman known";985;411;62;349;436;564
"5908";"3. RSIHR Known";"3. RSIHR Known";985;474;70;404;359;641
"5909";"4. Rosenberger known";"4. Rosenberger known";985;548;27;521;152;848
"5910";"5. Optimal adjusted";"5. Optimal adjusted";985;393;107;286;536;464
"5911";"1. Random";"1. Random";986;416;98;318;495;505
"5912";"6. Biased  coin";"6. Biased  coin";986;403;106;297;500;500
"5913";"2. Neyman known";"2. Neyman known";986;439;95;344;436;564
"5914";"3. RSIHR Known";"3. RSIHR Known";986;452;72;380;372;628
"5915";"4. Rosenberger known";"4. Rosenberger known";986;540;23;517;132;868
"5916";"5. Optimal adjusted";"5. Optimal adjusted";986;407;118;289;525;475
"5917";"1. Random";"1. Random";987;431;108;323;492;508
"5918";"6. Biased  coin";"6. Biased  coin";987;419;103;316;501;500
"5919";"2. Neyman known";"2. Neyman known";987;459;95;364;427;573
"5920";"3. RSIHR Known";"3. RSIHR Known";987;460;72;388;355;645
"5921";"4. Rosenberger known";"4. Rosenberger known";987;566;24;542;124;876
"5922";"5. Optimal adjusted";"5. Optimal adjusted";987;379;110;269;546;454
"5923";"1. Random";"1. Random";988;396;100;296;481;519
"5924";"6. Biased  coin";"6. Biased  coin";988;372;94;278;501;500
"5925";"2. Neyman known";"2. Neyman known";988;399;87;312;459;541
"5926";"3. RSIHR Known";"3. RSIHR Known";988;463;79;384;351;649
"5927";"4. Rosenberger known";"4. Rosenberger known";988;533;22;511;130;870
"5928";"5. Optimal adjusted";"5. Optimal adjusted";988;373;96;277;519;481
"5929";"1. Random";"1. Random";989;430;105;325;491;509
"5930";"6. Biased  coin";"6. Biased  coin";989;423;109;314;501;500
"5931";"2. Neyman known";"2. Neyman known";989;443;93;350;434;566
"5932";"3. RSIHR Known";"3. RSIHR Known";989;482;76;406;356;644
"5933";"4. Rosenberger known";"4. Rosenberger known";989;572;35;537;130;870
"5934";"5. Optimal adjusted";"5. Optimal adjusted";989;404;110;294;533;467
"5935";"1. Random";"1. Random";990;386;83;303;488;512
"5936";"6. Biased  coin";"6. Biased  coin";990;408;100;308;500;500
"5937";"2. Neyman known";"2. Neyman known";990;405;86;319;465;535
"5938";"3. RSIHR Known";"3. RSIHR Known";990;455;69;386;367;633
"5939";"4. Rosenberger known";"4. Rosenberger known";990;559;32;527;138;862
"5940";"5. Optimal adjusted";"5. Optimal adjusted";990;373;95;278;529;471
"5941";"1. Random";"1. Random";991;395;112;283;516;484
"5942";"6. Biased  coin";"6. Biased  coin";991;406;116;290;503;499
"5943";"2. Neyman known";"2. Neyman known";991;425;79;346;401;599
"5944";"3. RSIHR Known";"3. RSIHR Known";991;454;87;367;388;612
"5945";"4. Rosenberger known";"4. Rosenberger known";991;529;28;501;152;848
"5946";"5. Optimal adjusted";"5. Optimal adjusted";991;379;102;277;526;474
"5947";"1. Random";"1. Random";992;415;110;305;485;515
"5948";"6. Biased  coin";"6. Biased  coin";992;407;108;299;502;499
"5949";"2. Neyman known";"2. Neyman known";992;402;79;323;427;573
"5950";"3. RSIHR Known";"3. RSIHR Known";992;449;74;375;376;624
"5951";"4. Rosenberger known";"4. Rosenberger known";992;534;40;494;150;850
"5952";"5. Optimal adjusted";"5. Optimal adjusted";992;391;119;272;548;452
"5953";"1. Random";"1. Random";993;391;107;284;525;475
"5954";"6. Biased  coin";"6. Biased  coin";993;396;98;298;499;501
"5955";"2. Neyman known";"2. Neyman known";993;420;94;326;458;542
"5956";"3. RSIHR Known";"3. RSIHR Known";993;465;79;386;366;634
"5957";"4. Rosenberger known";"4. Rosenberger known";993;543;26;517;139;861
"5958";"5. Optimal adjusted";"5. Optimal adjusted";993;383;109;274;541;459
"5959";"1. Random";"1. Random";994;409;103;306;499;501
"5960";"6. Biased  coin";"6. Biased  coin";994;408;103;305;500;500
"5961";"2. Neyman known";"2. Neyman known";994;437;93;344;454;546
"5962";"3. RSIHR Known";"3. RSIHR Known";994;449;61;388;348;652
"5963";"4. Rosenberger known";"4. Rosenberger known";994;555;23;532;129;871
"5964";"5. Optimal adjusted";"5. Optimal adjusted";994;422;122;300;530;470
"5965";"1. Random";"1. Random";995;374;92;282;518;482
"5966";"6. Biased  coin";"6. Biased  coin";995;407;88;319;500;500
"5967";"2. Neyman known";"2. Neyman known";995;422;100;322;475;525
"5968";"3. RSIHR Known";"3. RSIHR Known";995;460;85;375;384;616
"5969";"4. Rosenberger known";"4. Rosenberger known";995;565;26;539;131;869
"5970";"5. Optimal adjusted";"5. Optimal adjusted";995;379;109;270;549;451
"5971";"1. Random";"1. Random";996;402;110;292;508;492
"5972";"6. Biased  coin";"6. Biased  coin";996;395;101;294;499;501
"5973";"2. Neyman known";"2. Neyman known";996;421;98;323;446;554
"5974";"3. RSIHR Known";"3. RSIHR Known";996;447;80;367;370;630
"5975";"4. Rosenberger known";"4. Rosenberger known";996;543;38;505;157;843
"5976";"5. Optimal adjusted";"5. Optimal adjusted";996;390;127;263;552;448
"5977";"1. Random";"1. Random";997;389;94;295;500;500
"5978";"6. Biased  coin";"6. Biased  coin";997;395;92;303;500;502
"5979";"2. Neyman known";"2. Neyman known";997;420;86;334;419;581
"5980";"3. RSIHR Known";"3. RSIHR Known";997;442;85;357;382;618
"5981";"4. Rosenberger known";"4. Rosenberger known";997;527;42;485;160;840
"5982";"5. Optimal adjusted";"5. Optimal adjusted";997;377;102;275;515;485
"5983";"1. Random";"1. Random";998;433;101;332;493;507
"5984";"6. Biased  coin";"6. Biased  coin";998;420;104;316;501;499
"5985";"2. Neyman known";"2. Neyman known";998;460;106;354;442;558
"5986";"3. RSIHR Known";"3. RSIHR Known";998;459;81;378;406;594
"5987";"4. Rosenberger known";"4. Rosenberger known";998;561;26;535;144;856
"5988";"5. Optimal adjusted";"5. Optimal adjusted";998;407;107;300;528;472
"5989";"1. Random";"1. Random";999;398;115;283;514;486
"5990";"6. Biased  coin";"6. Biased  coin";999;386;99;287;503;499
"5991";"2. Neyman known";"2. Neyman known";999;421;89;332;419;581
"5992";"3. RSIHR Known";"3. RSIHR Known";999;425;62;363;366;634
"5993";"4. Rosenberger known";"4. Rosenberger known";999;516;21;495;130;870
"5994";"5. Optimal adjusted";"5. Optimal adjusted";999;387;112;275;554;446
"5995";"1. Random";"1. Random";1000;414;102;312;483;517
"5996";"6. Biased  coin";"6. Biased  coin";1000;404;98;306;498;503
"5997";"2. Neyman known";"2. Neyman known";1000;410;111;299;486;514
"5998";"3. RSIHR Known";"3. RSIHR Known";1000;469;73;396;337;663
"5999";"4. Rosenberger known";"4. Rosenberger known";1000;543;22;521;123;877
"6000";"5";"5. Optimal adjusted";1000;412;104;308;488;512
