"";"Model";"Successes";"Successes_A";"Successes_B";"Allocated_A";"Allocated_B"
"1";"1. Random";379;81;298;511;489
"2";"6. Biased  coin";382;95;287;501;500
"3";"2. Neyman known";419;94;325;457;543
"4";"3. RSIHR Known";483;74;409;340;660
"5";"4. Rosenberger known";545;21;524;130;870
"6";"5. Optimal adjusted";375;89;286;540;460
"7";"1. Random";393;105;288;514;486
"8";"6. Biased  coin";404;111;293;503;500
"9";"2. Neyman known";436;101;335;462;538
"10";"3. RSIHR Known";452;85;367;385;615
"11";"4. Rosenberger known";553;24;529;117;883
"12";"5. Optimal adjusted";379;111;268;541;459
"13";"1. Random";383;112;271;503;497
"14";"6. Biased  coin";387;101;286;500;500
"15";"2. Neyman known";416;97;319;455;545
"16";"3. RSIHR Known";458;76;382;351;649
"17";"4. Rosenberger known";536;30;506;132;868
"18";"5. Optimal adjusted";368;120;248;554;446
"19";"1. Random";418;92;326;459;541
"20";"6. Biased  coin";404;99;305;501;499
"21";"2. Neyman known";411;89;322;457;543
"22";"3. RSIHR Known";450;80;370;398;602
"23";"4. Rosenberger known";557;27;530;118;882
"24";"5. Optimal adjusted";403;100;303;509;491
"25";"1. Random";377;103;274;516;484
"26";"6. Biased  coin";374;103;271;500;500
"27";"2. Neyman known";390;93;297;446;554
"28";"3. RSIHR Known";424;72;352;360;640
"29";"4. Rosenberger known";507;31;476;160;840
"30";"5. Optimal adjusted";365;102;263;533;467
"31";"1. Random";397;95;302;511;489
"32";"6. Biased  coin";388;95;293;499;501
"33";"2. Neyman known";396;78;318;440;560
"34";"3. RSIHR Known";462;74;388;361;639
"35";"4. Rosenberger known";527;18;509;137;863
"36";"5. Optimal adjusted";386;101;285;538;462
"37";"1. Random";420;98;322;488;512
"38";"6. Biased  coin";401;100;301;501;499
"39";"2. Neyman known";445;106;339;449;551
"40";"3. RSIHR Known";467;75;392;352;648
"41";"4. Rosenberger known";549;25;524;139;861
"42";"5. Optimal adjusted";400;99;301;525;475
"43";"1. Random";377;105;272;519;481
"44";"6. Biased  coin";366;98;268;499;501
"45";"2. Neyman known";376;102;274;498;502
"46";"3. RSIHR Known";415;77;338;374;626
"47";"4. Rosenberger known";524;39;485;143;857
"48";"5. Optimal adjusted";355;113;242;543;457
"49";"1. Random";413;93;320;478;522
"50";"6. Biased  coin";409;106;303;501;501
"51";"2. Neyman known";432;86;346;446;554
"52";"3. RSIHR Known";469;72;397;369;631
"53";"4. Rosenberger known";561;37;524;149;851
"54";"5. Optimal adjusted";403;98;305;533;467
"55";"1. Random";384;97;287;484;516
"56";"6. Biased  coin";389;102;287;501;500
"57";"2. Neyman known";398;84;314;446;554
"58";"3. RSIHR Known";442;58;384;352;648
"59";"4. Rosenberger known";539;29;510;132;868
"60";"5. Optimal adjusted";365;110;255;555;445
"61";"1. Random";406;98;308;489;511
"62";"6. Biased  coin";383;90;293;502;499
"63";"2. Neyman known";396;94;302;486;514
"64";"3. RSIHR Known";459;65;394;338;662
"65";"4. Rosenberger known";539;27;512;132;868
"66";"5. Optimal adjusted";407;107;300;511;489
"67";"1. Random";390;110;280;523;477
"68";"6. Biased  coin";388;100;288;499;501
"69";"2. Neyman known";431;89;342;442;558
"70";"3. RSIHR Known";449;61;388;358;642
"71";"4. Rosenberger known";550;29;521;145;855
"72";"5. Optimal adjusted";357;96;261;542;458
"73";"1. Random";407;101;306;481;519
"74";"6. Biased  coin";394;98;296;497;503
"75";"2. Neyman known";399;94;305;480;520
"76";"3. RSIHR Known";434;81;353;383;617
"77";"4. Rosenberger known";528;22;506;148;852
"78";"5. Optimal adjusted";394;111;283;553;447
"79";"1. Random";380;98;282;514;486
"80";"6. Biased  coin";419;112;307;500;500
"81";"2. Neyman known";438;92;346;434;566
"82";"3. RSIHR Known";473;74;399;337;663
"83";"4. Rosenberger known";561;35;526;144;856
"84";"5. Optimal adjusted";403;115;288;529;471
"85";"1. Random";416;100;316;498;502
"86";"6. Biased  coin";428;108;320;503;500
"87";"2. Neyman known";431;101;330;467;533
"88";"3. RSIHR Known";462;75;387;357;643
"89";"4. Rosenberger known";552;28;524;128;872
"90";"5. Optimal adjusted";383;105;278;546;454
"91";"1. Random";394;99;295;510;490
"92";"6. Biased  coin";400;96;304;498;502
"93";"2. Neyman known";432;83;349;431;569
"94";"3. RSIHR Known";443;65;378;374;626
"95";"4. Rosenberger known";545;30;515;138;862
"96";"5. Optimal adjusted";381;91;290;527;473
"97";"1. Random";388;94;294;505;495
"98";"6. Biased  coin";423;111;312;500;500
"99";"2. Neyman known";469;95;374;421;579
"100";"3. RSIHR Known";466;72;394;358;642
"101";"4. Rosenberger known";565;27;538;118;882
"102";"5. Optimal adjusted";392;106;286;524;476
"103";"1. Random";410;100;310;485;515
"104";"6. Biased  coin";369;93;276;501;500
"105";"2. Neyman known";398;82;316;439;561
"106";"3. RSIHR Known";401;69;332;386;614
"107";"4. Rosenberger known";518;31;487;142;858
"108";"5. Optimal adjusted";345;109;236;566;434
"109";"1. Random";427;108;319;496;504
"110";"6. Biased  coin";416;109;307;499;501
"111";"2. Neyman known";410;95;315;447;553
"112";"3. RSIHR Known";466;77;389;363;637
"113";"4. Rosenberger known";557;37;520;154;846
"114";"5. Optimal adjusted";402;110;292;533;467
"115";"1. Random";407;104;303;490;510
"116";"6. Biased  coin";411;108;303;500;500
"117";"2. Neyman known";426;114;312;487;513
"118";"3. RSIHR Known";435;78;357;390;610
"119";"4. Rosenberger known";534;29;505;145;855
"120";"5. Optimal adjusted";394;104;290;519;481
"121";"1. Random";381;109;272;523;477
"122";"6. Biased  coin";406;113;293;499;501
"123";"2. Neyman known";422;94;328;469;531
"124";"3. RSIHR Known";470;85;385;370;630
"125";"4. Rosenberger known";550;34;516;162;838
"126";"5. Optimal adjusted";373;112;261;541;459
"127";"1. Random";400;94;306;488;512
"128";"6. Biased  coin";416;117;299;500;501
"129";"2. Neyman known";437;90;347;422;578
"130";"3. RSIHR Known";463;93;370;386;614
"131";"4. Rosenberger known";529;36;493;166;834
"132";"5. Optimal adjusted";385;114;271;541;459
"133";"1. Random";422;96;326;493;507
"134";"6. Biased  coin";422;110;312;500;500
"135";"2. Neyman known";440;92;348;443;557
"136";"3. RSIHR Known";473;60;413;342;658
"137";"4. Rosenberger known";570;30;540;155;845
"138";"5. Optimal adjusted";407;99;308;545;455
"139";"1. Random";396;116;280;497;503
"140";"6. Biased  coin";400;111;289;502;504
"141";"2. Neyman known";425;103;322;446;554
"142";"3. RSIHR Known";452;100;352;393;607
"143";"4. Rosenberger known";517;28;489;147;853
"144";"5. Optimal adjusted";381;125;256;549;451
"145";"1. Random";432;117;315;490;510
"146";"6. Biased  coin";417;114;303;504;500
"147";"2. Neyman known";424;91;333;419;581
"148";"3. RSIHR Known";475;95;380;381;619
"149";"4. Rosenberger known";565;32;533;112;888
"150";"5. Optimal adjusted";396;134;262;564;436
"151";"1. Random";411;104;307;480;520
"152";"6. Biased  coin";401;101;300;498;502
"153";"2. Neyman known";411;98;313;460;540
"154";"3. RSIHR Known";448;81;367;393;607
"155";"4. Rosenberger known";536;33;503;140;860
"156";"5. Optimal adjusted";382;115;267;540;460
"157";"1. Random";391;99;292;516;484
"158";"6. Biased  coin";388;96;292;501;499
"159";"2. Neyman known";433;90;343;436;564
"160";"3. RSIHR Known";433;71;362;383;617
"161";"4. Rosenberger known";549;29;520;144;856
"162";"5. Optimal adjusted";384;93;291;528;472
"163";"1. Random";400;107;293;502;498
"164";"6. Biased  coin";414;104;310;499;501
"165";"2. Neyman known";439;92;347;429;571
"166";"3. RSIHR Known";446;74;372;347;653
"167";"4. Rosenberger known";507;17;490;141;859
"168";"5. Optimal adjusted";384;117;267;550;450
"169";"1. Random";380;104;276;503;497
"170";"6. Biased  coin";405;107;298;500;500
"171";"2. Neyman known";420;101;319;450;550
"172";"3. RSIHR Known";450;80;370;378;622
"173";"4. Rosenberger known";518;23;495;144;856
"174";"5. Optimal adjusted";376;114;262;540;460
"175";"1. Random";390;89;301;482;518
"176";"6. Biased  coin";370;89;281;502;499
"177";"2. Neyman known";412;69;343;411;589
"178";"3. RSIHR Known";441;68;373;359;641
"179";"4. Rosenberger known";517;27;490;151;849
"180";"5. Optimal adjusted";373;92;281;516;484
"181";"1. Random";416;99;317;493;507
"182";"6. Biased  coin";406;111;295;500;500
"183";"2. Neyman known";433;81;352;426;574
"184";"3. RSIHR Known";458;61;397;352;648
"185";"4. Rosenberger known";540;30;510;157;843
"186";"5. Optimal adjusted";395;110;285;533;467
"187";"1. Random";419;91;328;457;543
"188";"6. Biased  coin";398;93;305;500;500
"189";"2. Neyman known";437;100;337;465;535
"190";"3. RSIHR Known";446;84;362;381;619
"191";"4. Rosenberger known";546;20;526;140;860
"192";"5. Optimal adjusted";383;113;270;559;441
"193";"1. Random";412;87;325;466;534
"194";"6. Biased  coin";390;95;295;503;497
"195";"2. Neyman known";399;84;315;481;519
"196";"3. RSIHR Known";459;69;390;352;648
"197";"4. Rosenberger known";539;17;522;123;877
"198";"5. Optimal adjusted";358;99;259;552;448
"199";"1. Random";427;105;322;482;518
"200";"6. Biased  coin";396;108;288;499;501
"201";"2. Neyman known";445;115;330;461;539
"202";"3. RSIHR Known";451;95;356;407;593
"203";"4. Rosenberger known";545;31;514;149;851
"204";"5. Optimal adjusted";382;106;276;525;475
"205";"1. Random";391;104;287;497;503
"206";"6. Biased  coin";390;108;282;502;498
"207";"2. Neyman known";404;100;304;466;534
"208";"3. RSIHR Known";449;76;373;368;632
"209";"4. Rosenberger known";518;25;493;150;850
"210";"5. Optimal adjusted";385;106;279;523;477
"211";"1. Random";388;92;296;493;507
"212";"6. Biased  coin";392;105;287;502;499
"213";"2. Neyman known";423;96;327;438;562
"214";"3. RSIHR Known";426;88;338;422;578
"215";"4. Rosenberger known";511;26;485;152;848
"216";"5. Optimal adjusted";374;92;282;501;499
"217";"1. Random";408;95;313;477;523
"218";"6. Biased  coin";427;120;307;499;501
"219";"2. Neyman known";425;90;335;453;547
"220";"3. RSIHR Known";439;74;365;358;642
"221";"4. Rosenberger known";547;33;514;134;866
"222";"5. Optimal adjusted";395;109;286;501;499
"223";"1. Random";435;122;313;488;512
"224";"6. Biased  coin";425;126;299;500;500
"225";"2. Neyman known";417;109;308;476;524
"226";"3. RSIHR Known";441;82;359;376;624
"227";"4. Rosenberger known";529;29;500;160;840
"228";"5. Optimal adjusted";401;123;278;548;452
"229";"1. Random";400;111;289;512;488
"230";"6. Biased  coin";407;102;305;500;501
"231";"2. Neyman known";413;81;332;424;576
"232";"3. RSIHR Known";453;72;381;369;631
"233";"4. Rosenberger known";526;24;502;153;847
"234";"5. Optimal adjusted";374;108;266;534;466
"235";"1. Random";386;98;288;506;494
"236";"6. Biased  coin";386;94;292;500;500
"237";"2. Neyman known";401;97;304;473;527
"238";"3. RSIHR Known";426;72;354;394;606
"239";"4. Rosenberger known";521;26;495;143;857
"240";"5. Optimal adjusted";364;106;258;541;459
"241";"1. Random";413;92;321;488;512
"242";"6. Biased  coin";401;92;309;499;501
"243";"2. Neyman known";423;88;335;464;536
"244";"3. RSIHR Known";449;63;386;364;636
"245";"4. Rosenberger known";559;26;533;144;856
"246";"5. Optimal adjusted";391;114;277;550;450
"247";"1. Random";399;97;302;492;508
"248";"6. Biased  coin";407;107;300;503;499
"249";"2. Neyman known";444;97;347;436;564
"250";"3. RSIHR Known";449;74;375;365;635
"251";"4. Rosenberger known";532;27;505;142;858
"252";"5. Optimal adjusted";396;117;279;539;461
"253";"1. Random";395;109;286;487;513
"254";"6. Biased  coin";409;107;302;504;497
"255";"2. Neyman known";396;89;307;468;532
"256";"3. RSIHR Known";422;73;349;390;610
"257";"4. Rosenberger known";530;29;501;150;850
"258";"5. Optimal adjusted";382;116;266;554;446
"259";"1. Random";393;98;295;504;496
"260";"6. Biased  coin";412;103;309;503;500
"261";"2. Neyman known";424;94;330;453;547
"262";"3. RSIHR Known";436;63;373;383;617
"263";"4. Rosenberger known";558;32;526;141;859
"264";"5. Optimal adjusted";392;116;276;547;453
"265";"1. Random";391;98;293;512;488
"266";"6. Biased  coin";392;93;299;502;499
"267";"2. Neyman known";412;79;333;430;570
"268";"3. RSIHR Known";436;64;372;361;639
"269";"4. Rosenberger known";523;26;497;157;843
"270";"5. Optimal adjusted";389;108;281;530;470
"271";"1. Random";406;105;301;508;492
"272";"6. Biased  coin";379;93;286;502;499
"273";"2. Neyman known";420;94;326;446;554
"274";"3. RSIHR Known";453;76;377;357;643
"275";"4. Rosenberger known";521;20;501;138;862
"276";"5. Optimal adjusted";379;123;256;567;433
"277";"1. Random";415;110;305;506;494
"278";"6. Biased  coin";416;105;311;500;500
"279";"2. Neyman known";441;80;361;424;576
"280";"3. RSIHR Known";460;77;383;367;633
"281";"4. Rosenberger known";559;41;518;139;861
"282";"5. Optimal adjusted";390;101;289;527;473
"283";"1. Random";382;97;285;500;500
"284";"6. Biased  coin";380;93;287;499;501
"285";"2. Neyman known";397;73;324;444;556
"286";"3. RSIHR Known";435;69;366;376;624
"287";"4. Rosenberger known";528;31;497;158;842
"288";"5. Optimal adjusted";361;114;247;560;440
"289";"1. Random";432;115;317;510;490
"290";"6. Biased  coin";418;108;310;498;502
"291";"2. Neyman known";433;121;312;488;512
"292";"3. RSIHR Known";463;78;385;350;650
"293";"4. Rosenberger known";549;27;522;139;861
"294";"5. Optimal adjusted";395;114;281;531;469
"295";"1. Random";391;107;284;516;484
"296";"6. Biased  coin";399;104;295;501;499
"297";"2. Neyman known";436;94;342;430;570
"298";"3. RSIHR Known";449;82;367;370;630
"299";"4. Rosenberger known";556;30;526;123;877
"300";"5. Optimal adjusted";412;127;285;540;460
"301";"1. Random";386;104;282;516;484
"302";"6. Biased  coin";372;90;282;499;501
"303";"2. Neyman known";415;91;324;440;560
"304";"3. RSIHR Known";431;72;359;384;616
"305";"4. Rosenberger known";519;26;493;152;848
"306";"5. Optimal adjusted";359;94;265;540;460
"307";"1. Random";420;112;308;494;506
"308";"6. Biased  coin";410;108;302;499;501
"309";"2. Neyman known";413;89;324;444;556
"310";"3. RSIHR Known";449;70;379;363;637
"311";"4. Rosenberger known";529;22;507;141;859
"312";"5. Optimal adjusted";397;122;275;560;440
"313";"1. Random";399;99;300;498;502
"314";"6. Biased  coin";392;100;292;500;501
"315";"2. Neyman known";423;94;329;452;548
"316";"3. RSIHR Known";438;63;375;356;644
"317";"4. Rosenberger known";548;35;513;147;853
"318";"5. Optimal adjusted";388;112;276;537;463
"319";"1. Random";385;107;278;524;476
"320";"6. Biased  coin";405;110;295;503;497
"321";"2. Neyman known";448;103;345;432;568
"322";"3. RSIHR Known";461;74;387;362;638
"323";"4. Rosenberger known";540;33;507;161;839
"324";"5. Optimal adjusted";390;110;280;535;465
"325";"1. Random";418;107;311;480;520
"326";"6. Biased  coin";421;120;301;499;501
"327";"2. Neyman known";422;84;338;432;568
"328";"3. RSIHR Known";458;82;376;372;628
"329";"4. Rosenberger known";545;31;514;136;864
"330";"5. Optimal adjusted";393;113;280;534;466
"331";"1. Random";397;106;291;513;487
"332";"6. Biased  coin";400;104;296;501;500
"333";"2. Neyman known";430;96;334;454;546
"334";"3. RSIHR Known";441;75;366;383;617
"335";"4. Rosenberger known";544;25;519;130;870
"336";"5. Optimal adjusted";377;97;280;504;496
"337";"1. Random";408;102;306;504;496
"338";"6. Biased  coin";415;100;315;502;498
"339";"2. Neyman known";434;91;343;443;557
"340";"3. RSIHR Known";473;65;408;351;649
"341";"4. Rosenberger known";557;38;519;151;849
"342";"5. Optimal adjusted";394;117;277;539;461
"343";"1. Random";358;102;256;524;476
"344";"6. Biased  coin";380;96;284;501;500
"345";"2. Neyman known";392;87;305;467;533
"346";"3. RSIHR Known";423;74;349;369;631
"347";"4. Rosenberger known";518;23;495;136;864
"348";"5. Optimal adjusted";343;92;251;540;460
"349";"1. Random";387;102;285;498;502
"350";"6. Biased  coin";397;103;294;502;500
"351";"2. Neyman known";427;95;332;456;544
"352";"3. RSIHR Known";456;72;384;352;648
"353";"4. Rosenberger known";518;28;490;154;846
"354";"5. Optimal adjusted";377;99;278;519;481
"355";"1. Random";423;97;326;467;533
"356";"6. Biased  coin";392;91;301;500;500
"357";"2. Neyman known";438;97;341;451;549
"358";"3. RSIHR Known";483;90;393;361;639
"359";"4. Rosenberger known";542;35;507;150;850
"360";"5. Optimal adjusted";381;96;285;522;478
"361";"1. Random";368;92;276;501;499
"362";"6. Biased  coin";362;94;268;501;500
"363";"2. Neyman known";398;91;307;460;540
"364";"3. RSIHR Known";419;69;350;366;634
"365";"4. Rosenberger known";500;26;474;139;861
"366";"5. Optimal adjusted";359;91;268;515;485
"367";"1. Random";423;116;307;487;513
"368";"6. Biased  coin";403;108;295;500;500
"369";"2. Neyman known";429;94;335;445;555
"370";"3. RSIHR Known";467;78;389;368;632
"371";"4. Rosenberger known";544;36;508;152;848
"372";"5. Optimal adjusted";413;129;284;539;461
"373";"1. Random";399;95;304;493;507
"374";"6. Biased  coin";400;97;303;501;500
"375";"2. Neyman known";405;88;317;471;529
"376";"3. RSIHR Known";447;74;373;393;607
"377";"4. Rosenberger known";566;26;540;133;867
"378";"5. Optimal adjusted";395;109;286;529;471
"379";"1. Random";387;93;294;506;494
"380";"6. Biased  coin";396;91;305;500;500
"381";"2. Neyman known";399;78;321;446;554
"382";"3. RSIHR Known";455;62;393;342;658
"383";"4. Rosenberger known";555;27;528;137;863
"384";"5. Optimal adjusted";367;92;275;556;444
"385";"1. Random";384;98;286;495;505
"386";"6. Biased  coin";378;92;286;501;500
"387";"2. Neyman known";396;84;312;437;563
"388";"3. RSIHR Known";424;82;342;395;605
"389";"4. Rosenberger known";519;35;484;148;852
"390";"5. Optimal adjusted";379;106;273;526;474
"391";"1. Random";422;108;314;491;509
"392";"6. Biased  coin";401;107;294;503;500
"393";"2. Neyman known";432;103;329;456;544
"394";"3. RSIHR Known";467;77;390;351;649
"395";"4. Rosenberger known";543;24;519;137;863
"396";"5. Optimal adjusted";395;102;293;521;479
"397";"1. Random";411;105;306;496;504
"398";"6. Biased  coin";417;103;314;503;499
"399";"2. Neyman known";422;92;330;470;530
"400";"3. RSIHR Known";444;68;376;364;636
"401";"4. Rosenberger known";553;37;516;142;858
"402";"5. Optimal adjusted";392;118;274;563;437
"403";"1. Random";386;82;304;480;520
"404";"6. Biased  coin";409;116;293;500;501
"405";"2. Neyman known";424;96;328;461;539
"406";"3. RSIHR Known";434;74;360;386;614
"407";"4. Rosenberger known";534;29;505;137;863
"408";"5. Optimal adjusted";373;99;274;536;464
"409";"1. Random";399;110;289;501;499
"410";"6. Biased  coin";407;108;299;502;500
"411";"2. Neyman known";409;91;318;443;557
"412";"3. RSIHR Known";443;74;369;367;633
"413";"4. Rosenberger known";533;40;493;157;843
"414";"5. Optimal adjusted";370;107;263;534;466
"415";"1. Random";406;95;311;498;502
"416";"6. Biased  coin";371;86;285;501;500
"417";"2. Neyman known";425;75;350;429;571
"418";"3. RSIHR Known";435;65;370;377;623
"419";"4. Rosenberger known";538;26;512;144;856
"420";"5. Optimal adjusted";382;94;288;538;462
"421";"1. Random";382;99;283;497;503
"422";"6. Biased  coin";402;103;299;498;502
"423";"2. Neyman known";409;80;329;426;574
"424";"3. RSIHR Known";435;69;366;361;639
"425";"4. Rosenberger known";522;35;487;143;857
"426";"5. Optimal adjusted";387;119;268;530;470
"427";"1. Random";349;80;269;518;482
"428";"6. Biased  coin";383;91;292;500;501
"429";"2. Neyman known";392;84;308;455;545
"430";"3. RSIHR Known";417;83;334;381;619
"431";"4. Rosenberger known";497;33;464;145;855
"432";"5. Optimal adjusted";359;95;264;522;478
"433";"1. Random";394;99;295;485;515
"434";"6. Biased  coin";406;119;287;499;501
"435";"2. Neyman known";422;101;321;464;536
"436";"3. RSIHR Known";466;75;391;338;662
"437";"4. Rosenberger known";529;34;495;154;846
"438";"5. Optimal adjusted";391;112;279;527;473
"439";"1. Random";418;121;297;511;489
"440";"6. Biased  coin";407;101;306;503;498
"441";"2. Neyman known";405;95;310;455;545
"442";"3. RSIHR Known";453;74;379;352;648
"443";"4. Rosenberger known";547;29;518;149;851
"444";"5. Optimal adjusted";405;111;294;513;487
"445";"1. Random";398;114;284;515;485
"446";"6. Biased  coin";381;104;277;500;500
"447";"2. Neyman known";386;96;290;468;532
"448";"3. RSIHR Known";435;86;349;388;612
"449";"4. Rosenberger known";516;29;487;129;871
"450";"5. Optimal adjusted";384;109;275;535;465
"451";"1. Random";419;109;310;489;511
"452";"6. Biased  coin";393;109;284;501;500
"453";"2. Neyman known";421;109;312;449;551
"454";"3. RSIHR Known";466;78;388;348;652
"455";"4. Rosenberger known";548;30;518;126;874
"456";"5. Optimal adjusted";389;117;272;520;480
"457";"1. Random";374;100;274;509;491
"458";"6. Biased  coin";408;110;298;499;501
"459";"2. Neyman known";418;99;319;469;531
"460";"3. RSIHR Known";470;84;386;355;645
"461";"4. Rosenberger known";545;31;514;152;848
"462";"5. Optimal adjusted";402;112;290;532;468
"463";"1. Random";385;106;279;522;478
"464";"6. Biased  coin";395;101;294;501;500
"465";"2. Neyman known";400;87;313;465;535
"466";"3. RSIHR Known";447;67;380;357;643
"467";"4. Rosenberger known";527;30;497;151;849
"468";"5. Optimal adjusted";385;113;272;542;458
"469";"1. Random";399;97;302;489;511
"470";"6. Biased  coin";378;93;285;499;501
"471";"2. Neyman known";417;94;323;460;540
"472";"3. RSIHR Known";407;74;333;385;615
"473";"4. Rosenberger known";519;33;486;160;840
"474";"5. Optimal adjusted";374;105;269;530;470
"475";"1. Random";409;100;309;510;490
"476";"6. Biased  coin";419;113;306;503;499
"477";"2. Neyman known";406;101;305;473;527
"478";"3. RSIHR Known";440;83;357;395;605
"479";"4. Rosenberger known";538;26;512;134;866
"480";"5. Optimal adjusted";379;108;271;538;462
"481";"1. Random";392;92;300;480;520
"482";"6. Biased  coin";394;104;290;502;499
"483";"2. Neyman known";420;95;325;467;533
"484";"3. RSIHR Known";443;64;379;361;639
"485";"4. Rosenberger known";525;27;498;145;855
"486";"5. Optimal adjusted";373;103;270;554;446
"487";"1. Random";430;115;315;493;507
"488";"6. Biased  coin";404;104;300;500;500
"489";"2. Neyman known";459;104;355;429;571
"490";"3. RSIHR Known";456;84;372;393;607
"491";"4. Rosenberger known";566;35;531;141;859
"492";"5. Optimal adjusted";396;106;290;526;474
"493";"1. Random";402;101;301;496;504
"494";"6. Biased  coin";404;99;305;502;498
"495";"2. Neyman known";419;93;326;457;543
"496";"3. RSIHR Known";451;77;374;377;623
"497";"4. Rosenberger known";552;29;523;139;861
"498";"5. Optimal adjusted";376;106;270;538;462
"499";"1. Random";409;91;318;476;524
"500";"6. Biased  coin";386;103;283;502;499
"501";"2. Neyman known";431;84;347;427;573
"502";"3. RSIHR Known";447;63;384;352;648
"503";"4. Rosenberger known";536;19;517;123;877
"504";"5. Optimal adjusted";384;99;285;518;482
"505";"1. Random";414;105;309;510;490
"506";"6. Biased  coin";391;99;292;503;499
"507";"2. Neyman known";415;80;335;451;549
"508";"3. RSIHR Known";448;62;386;361;639
"509";"4. Rosenberger known";551;27;524;131;869
"510";"5. Optimal adjusted";368;92;276;530;470
"511";"1. Random";408;109;299;494;506
"512";"6. Biased  coin";394;100;294;499;501
"513";"2. Neyman known";401;88;313;460;540
"514";"3. RSIHR Known";433;65;368;390;610
"515";"4. Rosenberger known";538;27;511;147;853
"516";"5. Optimal adjusted";393;122;271;555;445
"517";"1. Random";353;92;261;534;466
"518";"6. Biased  coin";395;95;300;501;499
"519";"2. Neyman known";424;103;321;458;542
"520";"3. RSIHR Known";439;70;369;369;631
"521";"4. Rosenberger known";536;28;508;142;858
"522";"5. Optimal adjusted";379;104;275;551;449
"523";"1. Random";400;103;297;507;493
"524";"6. Biased  coin";396;98;298;501;501
"525";"2. Neyman known";439;81;358;419;581
"526";"3. RSIHR Known";455;80;375;385;615
"527";"4. Rosenberger known";556;22;534;124;876
"528";"5. Optimal adjusted";394;112;282;531;469
"529";"1. Random";397;100;297;508;492
"530";"6. Biased  coin";392;96;296;502;499
"531";"2. Neyman known";409;89;320;446;554
"532";"3. RSIHR Known";455;82;373;375;625
"533";"4. Rosenberger known";533;39;494;158;842
"534";"5. Optimal adjusted";364;108;256;567;433
"535";"1. Random";413;99;314;497;503
"536";"6. Biased  coin";398;102;296;502;500
"537";"2. Neyman known";414;84;330;440;560
"538";"3. RSIHR Known";469;86;383;350;650
"539";"4. Rosenberger known";546;26;520;141;859
"540";"5. Optimal adjusted";386;117;269;540;460
"541";"1. Random";397;108;289;492;508
"542";"6. Biased  coin";393;100;293;500;500
"543";"2. Neyman known";440;113;327;453;547
"544";"3. RSIHR Known";464;74;390;358;642
"545";"4. Rosenberger known";540;27;513;133;867
"546";"5. Optimal adjusted";386;115;271;536;464
"547";"1. Random";420;106;314;474;526
"548";"6. Biased  coin";428;116;312;500;500
"549";"2. Neyman known";444;102;342;413;587
"550";"3. RSIHR Known";470;94;376;373;627
"551";"4. Rosenberger known";539;33;506;136;864
"552";"5. Optimal adjusted";389;119;270;547;453
"553";"1. Random";432;99;333;498;502
"554";"6. Biased  coin";396;96;300;501;500
"555";"2. Neyman known";465;102;363;440;560
"556";"3. RSIHR Known";479;81;398;361;639
"557";"4. Rosenberger known";570;24;546;121;879
"558";"5. Optimal adjusted";394;105;289;538;462
"559";"1. Random";402;105;297;489;511
"560";"6. Biased  coin";416;111;305;501;501
"561";"2. Neyman known";398;91;307;457;543
"562";"3. RSIHR Known";429;83;346;379;621
"563";"4. Rosenberger known";535;35;500;143;857
"564";"5. Optimal adjusted";391;108;283;525;475
"565";"1. Random";413;108;305;497;503
"566";"6. Biased  coin";407;106;301;500;500
"567";"2. Neyman known";416;89;327;461;539
"568";"3. RSIHR Known";453;73;380;377;623
"569";"4. Rosenberger known";546;32;514;147;853
"570";"5. Optimal adjusted";390;112;278;535;465
"571";"1. Random";390;106;284;527;473
"572";"6. Biased  coin";399;99;300;500;500
"573";"2. Neyman known";436;81;355;433;567
"574";"3. RSIHR Known";469;76;393;352;648
"575";"4. Rosenberger known";553;22;531;141;859
"576";"5. Optimal adjusted";391;104;287;532;468
"577";"1. Random";406;102;304;489;511
"578";"6. Biased  coin";391;100;291;502;500
"579";"2. Neyman known";385;71;314;429;571
"580";"3. RSIHR Known";428;79;349;389;611
"581";"4. Rosenberger known";526;26;500;121;879
"582";"5. Optimal adjusted";370;117;253;566;434
"583";"1. Random";381;100;281;514;486
"584";"6. Biased  coin";393;102;291;502;499
"585";"2. Neyman known";433;94;339;433;567
"586";"3. RSIHR Known";441;78;363;372;628
"587";"4. Rosenberger known";528;24;504;152;848
"588";"5. Optimal adjusted";384;110;274;527;473
"589";"1. Random";397;107;290;514;486
"590";"6. Biased  coin";394;99;295;501;500
"591";"2. Neyman known";416;90;326;470;530
"592";"3. RSIHR Known";445;83;362;398;602
"593";"4. Rosenberger known";548;26;522;133;867
"594";"5. Optimal adjusted";374;101;273;545;455
"595";"1. Random";430;118;312;480;520
"596";"6. Biased  coin";384;107;277;501;500
"597";"2. Neyman known";402;102;300;456;544
"598";"3. RSIHR Known";433;81;352;353;647
"599";"4. Rosenberger known";513;28;485;135;865
"600";"5. Optimal adjusted";394;127;267;544;456
"601";"1. Random";409;120;289;505;495
"602";"6. Biased  coin";398;95;303;502;500
"603";"2. Neyman known";418;87;331;438;562
"604";"3. RSIHR Known";440;77;363;382;618
"605";"4. Rosenberger known";527;24;503;137;863
"606";"5. Optimal adjusted";392;115;277;535;465
"607";"1. Random";401;107;294;504;496
"608";"6. Biased  coin";414;112;302;500;501
"609";"2. Neyman known";423;97;326;447;553
"610";"3. RSIHR Known";456;81;375;367;633
"611";"4. Rosenberger known";526;35;491;155;845
"612";"5. Optimal adjusted";387;119;268;545;455
"613";"1. Random";390;97;293;517;483
"614";"6. Biased  coin";399;100;299;498;502
"615";"2. Neyman known";413;90;323;469;531
"616";"3. RSIHR Known";442;59;383;350;650
"617";"4. Rosenberger known";539;33;506;166;834
"618";"5. Optimal adjusted";376;110;266;553;447
"619";"1. Random";392;99;293;516;484
"620";"6. Biased  coin";389;96;293;501;501
"621";"2. Neyman known";412;91;321;471;529
"622";"3. RSIHR Known";446;66;380;357;643
"623";"4. Rosenberger known";543;34;509;145;855
"624";"5. Optimal adjusted";397;112;285;519;481
"625";"1. Random";411;100;311;479;521
"626";"6. Biased  coin";403;103;300;501;499
"627";"2. Neyman known";407;101;306;463;537
"628";"3. RSIHR Known";460;81;379;369;631
"629";"4. Rosenberger known";527;28;499;145;855
"630";"5. Optimal adjusted";385;104;281;517;483
"631";"1. Random";403;103;300;498;502
"632";"6. Biased  coin";391;111;280;500;500
"633";"2. Neyman known";425;94;331;430;570
"634";"3. RSIHR Known";462;80;382;379;621
"635";"4. Rosenberger known";532;29;503;158;842
"636";"5. Optimal adjusted";400;107;293;512;488
"637";"1. Random";424;91;333;468;532
"638";"6. Biased  coin";393;90;303;498;502
"639";"2. Neyman known";416;88;328;451;549
"640";"3. RSIHR Known";453;61;392;349;651
"641";"4. Rosenberger known";551;29;522;127;873
"642";"5. Optimal adjusted";369;112;257;552;448
"643";"1. Random";404;108;296;519;481
"644";"6. Biased  coin";407;106;301;501;500
"645";"2. Neyman known";436;90;346;449;551
"646";"3. RSIHR Known";472;73;399;353;647
"647";"4. Rosenberger known";561;32;529;142;858
"648";"5. Optimal adjusted";403;104;299;535;465
"649";"1. Random";435;109;326;480;520
"650";"6. Biased  coin";420;109;311;500;500
"651";"2. Neyman known";438;100;338;457;543
"652";"3. RSIHR Known";462;67;395;354;646
"653";"4. Rosenberger known";553;32;521;151;849
"654";"5. Optimal adjusted";402;124;278;534;466
"655";"1. Random";412;101;311;491;509
"656";"6. Biased  coin";404;102;302;501;500
"657";"2. Neyman known";426;78;348;425;575
"658";"3. RSIHR Known";449;71;378;374;626
"659";"4. Rosenberger known";530;27;503;156;844
"660";"5. Optimal adjusted";370;82;288;516;484
"661";"1. Random";413;100;313;496;504
"662";"6. Biased  coin";417;104;313;502;499
"663";"2. Neyman known";444;91;353;432;568
"664";"3. RSIHR Known";485;79;406;366;634
"665";"4. Rosenberger known";570;38;532;146;854
"666";"5. Optimal adjusted";415;107;308;526;474
"667";"1. Random";409;103;306;494;506
"668";"6. Biased  coin";396;100;296;499;501
"669";"2. Neyman known";419;83;336;448;552
"670";"3. RSIHR Known";467;81;386;378;622
"671";"4. Rosenberger known";549;22;527;130;870
"672";"5. Optimal adjusted";408;116;292;522;478
"673";"1. Random";402;91;311;482;518
"674";"6. Biased  coin";375;101;274;503;499
"675";"2. Neyman known";411;83;328;439;561
"676";"3. RSIHR Known";431;68;363;362;638
"677";"4. Rosenberger known";498;23;475;157;843
"678";"5. Optimal adjusted";378;104;274;532;468
"679";"1. Random";393;107;286;529;471
"680";"6. Biased  coin";403;95;308;498;502
"681";"2. Neyman known";430;86;344;434;566
"682";"3. RSIHR Known";468;74;394;351;649
"683";"4. Rosenberger known";545;28;517;157;843
"684";"5. Optimal adjusted";406;110;296;509;491
"685";"1. Random";389;105;284;512;488
"686";"6. Biased  coin";404;97;307;502;500
"687";"2. Neyman known";441;100;341;444;556
"688";"3. RSIHR Known";460;84;376;363;637
"689";"4. Rosenberger known";542;27;515;135;865
"690";"5. Optimal adjusted";418;127;291;536;464
"691";"1. Random";391;103;288;504;496
"692";"6. Biased  coin";381;100;281;502;500
"693";"2. Neyman known";397;91;306;467;533
"694";"3. RSIHR Known";440;70;370;376;624
"695";"4. Rosenberger known";525;28;497;144;856
"696";"5. Optimal adjusted";359;110;249;553;447
"697";"1. Random";408;113;295;482;518
"698";"6. Biased  coin";399;113;286;499;501
"699";"2. Neyman known";387;78;309;427;573
"700";"3. RSIHR Known";424;76;348;380;620
"701";"4. Rosenberger known";512;28;484;137;863
"702";"5. Optimal adjusted";372;110;262;524;476
"703";"1. Random";438;89;349;458;542
"704";"6. Biased  coin";385;84;301;499;501
"705";"2. Neyman known";413;87;326;466;534
"706";"3. RSIHR Known";461;64;397;354;646
"707";"4. Rosenberger known";560;30;530;144;856
"708";"5. Optimal adjusted";372;88;284;526;474
"709";"1. Random";415;97;318;499;501
"710";"6. Biased  coin";418;107;311;499;501
"711";"2. Neyman known";440;94;346;438;562
"712";"3. RSIHR Known";474;76;398;352;648
"713";"4. Rosenberger known";569;36;533;146;854
"714";"5. Optimal adjusted";401;108;293;544;456
"715";"1. Random";379;87;292;487;513
"716";"6. Biased  coin";374;95;279;499;501
"717";"2. Neyman known";389;79;310;447;553
"718";"3. RSIHR Known";428;70;358;368;632
"719";"4. Rosenberger known";518;29;489;139;861
"720";"5. Optimal adjusted";379;99;280;520;480
"721";"1. Random";398;99;299;494;506
"722";"6. Biased  coin";383;98;285;502;499
"723";"2. Neyman known";397;93;304;452;548
"724";"3. RSIHR Known";451;67;384;333;667
"725";"4. Rosenberger known";537;38;499;142;858
"726";"5. Optimal adjusted";382;116;266;551;449
"727";"1. Random";389;114;275;490;510
"728";"6. Biased  coin";413;118;295;503;499
"729";"2. Neyman known";408;99;309;459;541
"730";"3. RSIHR Known";434;71;363;363;637
"731";"4. Rosenberger known";517;27;490;144;856
"732";"5. Optimal adjusted";387;114;273;525;475
"733";"1. Random";381;93;288;502;498
"734";"6. Biased  coin";389;91;298;504;497
"735";"2. Neyman known";410;90;320;454;546
"736";"3. RSIHR Known";439;64;375;362;638
"737";"4. Rosenberger known";517;28;489;154;846
"738";"5. Optimal adjusted";378;104;274;511;489
"739";"1. Random";404;99;305;488;512
"740";"6. Biased  coin";397;99;298;500;500
"741";"2. Neyman known";435;85;350;416;584
"742";"3. RSIHR Known";442;69;373;378;622
"743";"4. Rosenberger known";546;37;509;142;858
"744";"5. Optimal adjusted";390;109;281;528;472
"745";"1. Random";422;108;314;484;516
"746";"6. Biased  coin";403;110;293;505;497
"747";"2. Neyman known";423;92;331;431;569
"748";"3. RSIHR Known";457;93;364;375;625
"749";"4. Rosenberger known";543;32;511;146;854
"750";"5. Optimal adjusted";385;122;263;556;444
"751";"1. Random";398;114;284;527;473
"752";"6. Biased  coin";404;107;297;502;499
"753";"2. Neyman known";442;99;343;430;570
"754";"3. RSIHR Known";477;76;401;344;656
"755";"4. Rosenberger known";545;28;517;142;858
"756";"5. Optimal adjusted";391;111;280;523;477
"757";"1. Random";419;108;311;495;505
"758";"6. Biased  coin";399;96;303;501;500
"759";"2. Neyman known";417;78;339;425;575
"760";"3. RSIHR Known";449;63;386;353;647
"761";"4. Rosenberger known";538;24;514;143;857
"762";"5. Optimal adjusted";390;100;290;521;479
"763";"1. Random";392;99;293;488;512
"764";"6. Biased  coin";429;109;320;503;499
"765";"2. Neyman known";416;91;325;466;534
"766";"3. RSIHR Known";448;73;375;376;624
"767";"4. Rosenberger known";527;16;511;124;876
"768";"5. Optimal adjusted";409;116;293;514;486
"769";"1. Random";386;91;295;503;497
"770";"6. Biased  coin";374;86;288;500;500
"771";"2. Neyman known";396;87;309;492;508
"772";"3. RSIHR Known";430;64;366;373;627
"773";"4. Rosenberger known";509;16;493;150;850
"774";"5. Optimal adjusted";357;95;262;529;471
"775";"1. Random";374;93;281;494;506
"776";"6. Biased  coin";377;88;289;499;501
"777";"2. Neyman known";406;91;315;451;549
"778";"3. RSIHR Known";442;74;368;361;639
"779";"4. Rosenberger known";510;27;483;153;847
"780";"5. Optimal adjusted";363;99;264;530;470
"781";"1. Random";411;112;299;517;483
"782";"6. Biased  coin";424;109;315;504;500
"783";"2. Neyman known";427;88;339;436;564
"784";"3. RSIHR Known";490;89;401;344;656
"785";"4. Rosenberger known";540;25;515;149;851
"786";"5. Optimal adjusted";391;130;261;575;425
"787";"1. Random";413;122;291;516;484
"788";"6. Biased  coin";385;99;286;504;500
"789";"2. Neyman known";422;89;333;407;593
"790";"3. RSIHR Known";460;81;379;361;639
"791";"4. Rosenberger known";528;37;491;164;836
"792";"5. Optimal adjusted";380;97;283;527;473
"793";"1. Random";409;106;303;525;475
"794";"6. Biased  coin";410;100;310;502;500
"795";"2. Neyman known";435;81;354;427;573
"796";"3. RSIHR Known";462;77;385;370;630
"797";"4. Rosenberger known";553;18;535;124;876
"798";"5. Optimal adjusted";380;116;264;558;442
"799";"1. Random";413;126;287;502;498
"800";"6. Biased  coin";397;111;286;499;501
"801";"2. Neyman known";423;100;323;438;562
"802";"3. RSIHR Known";446;90;356;369;631
"803";"4. Rosenberger known";519;32;487;144;856
"804";"5. Optimal adjusted";403;126;277;523;477
"805";"1. Random";396;110;286;522;478
"806";"6. Biased  coin";418;116;302;500;501
"807";"2. Neyman known";435;97;338;461;539
"808";"3. RSIHR Known";470;76;394;367;633
"809";"4. Rosenberger known";555;30;525;135;865
"810";"5. Optimal adjusted";410;120;290;530;470
"811";"1. Random";414;108;306;504;496
"812";"6. Biased  coin";411;107;304;501;499
"813";"2. Neyman known";454;82;372;398;602
"814";"3. RSIHR Known";465;78;387;363;637
"815";"4. Rosenberger known";556;29;527;135;865
"816";"5. Optimal adjusted";387;106;281;539;461
"817";"1. Random";403;100;303;484;516
"818";"6. Biased  coin";377;101;276;500;501
"819";"2. Neyman known";408;94;314;458;542
"820";"3. RSIHR Known";448;76;372;372;628
"821";"4. Rosenberger known";531;32;499;145;855
"822";"5. Optimal adjusted";378;120;258;555;445
"823";"1. Random";414;124;290;524;476
"824";"6. Biased  coin";414;112;302;498;502
"825";"2. Neyman known";432;103;329;449;551
"826";"3. RSIHR Known";487;86;401;347;653
"827";"4. Rosenberger known";554;32;522;148;852
"828";"5. Optimal adjusted";384;118;266;561;439
"829";"1. Random";395;89;306;465;535
"830";"6. Biased  coin";389;98;291;500;500
"831";"2. Neyman known";401;82;319;445;555
"832";"3. RSIHR Known";459;56;403;334;666
"833";"4. Rosenberger known";530;22;508;137;863
"834";"5. Optimal adjusted";377;120;257;550;450
"835";"1. Random";430;113;317;484;516
"836";"6. Biased  coin";406;116;290;500;500
"837";"2. Neyman known";437;104;333;455;545
"838";"3. RSIHR Known";456;88;368;371;629
"839";"4. Rosenberger known";538;24;514;117;883
"840";"5. Optimal adjusted";401;103;298;514;486
"841";"1. Random";416;124;292;521;479
"842";"6. Biased  coin";383;103;280;503;499
"843";"2. Neyman known";447;100;347;434;566
"844";"3. RSIHR Known";430;80;350;384;616
"845";"4. Rosenberger known";535;33;502;157;843
"846";"5. Optimal adjusted";391;121;270;543;457
"847";"1. Random";443;120;323;491;509
"848";"6. Biased  coin";431;121;310;500;500
"849";"2. Neyman known";447;110;337;455;545
"850";"3. RSIHR Known";470;87;383;385;615
"851";"4. Rosenberger known";570;34;536;141;859
"852";"5. Optimal adjusted";394;126;268;554;446
"853";"1. Random";417;103;314;475;525
"854";"6. Biased  coin";405;114;291;499;501
"855";"2. Neyman known";395;88;307;449;551
"856";"3. RSIHR Known";443;95;348;393;607
"857";"4. Rosenberger known";522;31;491;143;857
"858";"5. Optimal adjusted";390;117;273;518;482
"859";"1. Random";404;92;312;493;507
"860";"6. Biased  coin";385;96;289;500;500
"861";"2. Neyman known";430;100;330;444;556
"862";"3. RSIHR Known";452;75;377;356;644
"863";"4. Rosenberger known";535;32;503;150;850
"864";"5. Optimal adjusted";392;118;274;534;466
"865";"1. Random";390;118;272;487;513
"866";"6. Biased  coin";394;108;286;498;502
"867";"2. Neyman known";410;115;295;472;528
"868";"3. RSIHR Known";451;80;371;357;643
"869";"4. Rosenberger known";522;36;486;141;859
"870";"5. Optimal adjusted";390;129;261;551;449
"871";"1. Random";401;111;290;521;479
"872";"6. Biased  coin";432;125;307;502;498
"873";"2. Neyman known";434;117;317;470;530
"874";"3. RSIHR Known";472;79;393;354;646
"875";"4. Rosenberger known";541;28;513;134;866
"876";"5. Optimal adjusted";410;120;290;525;475
"877";"1. Random";430;105;325;485;515
"878";"6. Biased  coin";421;102;319;498;502
"879";"2. Neyman known";412;89;323;467;533
"880";"3. RSIHR Known";462;69;393;374;626
"881";"4. Rosenberger known";553;26;527;141;859
"882";"5. Optimal adjusted";400;100;300;521;479
"883";"1. Random";406;100;306;495;505
"884";"6. Biased  coin";420;104;316;499;501
"885";"2. Neyman known";450;93;357;438;562
"886";"3. RSIHR Known";467;85;382;376;624
"887";"4. Rosenberger known";554;33;521;145;855
"888";"5. Optimal adjusted";393;118;275;542;458
"889";"1. Random";406;108;298;497;503
"890";"6. Biased  coin";394;110;284;503;498
"891";"2. Neyman known";402;93;309;458;542
"892";"3. RSIHR Known";472;79;393;346;654
"893";"4. Rosenberger known";553;31;522;143;857
"894";"5. Optimal adjusted";391;115;276;553;447
"895";"1. Random";399;85;314;485;515
"896";"6. Biased  coin";404;98;306;502;500
"897";"2. Neyman known";421;94;327;457;543
"898";"3. RSIHR Known";452;68;384;372;628
"899";"4. Rosenberger known";548;33;515;142;858
"900";"5. Optimal adjusted";382;99;283;524;476
"901";"1. Random";410;100;310;474;526
"902";"6. Biased  coin";389;101;288;501;500
"903";"2. Neyman known";413;89;324;434;566
"904";"3. RSIHR Known";442;84;358;391;609
"905";"4. Rosenberger known";518;26;492;147;853
"906";"5. Optimal adjusted";372;102;270;543;457
"907";"1. Random";403;97;306;491;509
"908";"6. Biased  coin";408;108;300;501;499
"909";"2. Neyman known";398;96;302;477;523
"910";"3. RSIHR Known";465;68;397;358;642
"911";"4. Rosenberger known";533;24;509;150;850
"912";"5. Optimal adjusted";401;110;291;510;490
"913";"1. Random";402;101;301;494;506
"914";"6. Biased  coin";402;103;299;501;499
"915";"2. Neyman known";418;97;321;452;548
"916";"3. RSIHR Known";456;88;368;384;616
"917";"4. Rosenberger known";551;41;510;159;841
"918";"5. Optimal adjusted";372;92;280;527;473
"919";"1. Random";360;74;286;497;503
"920";"6. Biased  coin";390;88;302;500;500
"921";"2. Neyman known";408;91;317;449;551
"922";"3. RSIHR Known";442;70;372;372;628
"923";"4. Rosenberger known";519;24;495;151;849
"924";"5. Optimal adjusted";376;105;271;548;452
"925";"1. Random";402;99;303;483;517
"926";"6. Biased  coin";381;91;290;499;503
"927";"2. Neyman known";434;103;331;451;549
"928";"3. RSIHR Known";445;74;371;363;637
"929";"4. Rosenberger known";533;29;504;135;865
"930";"5. Optimal adjusted";376;101;275;523;477
"931";"1. Random";365;87;278;504;496
"932";"6. Biased  coin";390;100;290;502;499
"933";"2. Neyman known";397;83;314;446;554
"934";"3. RSIHR Known";435;62;373;349;651
"935";"4. Rosenberger known";530;21;509;120;880
"936";"5. Optimal adjusted";362;96;266;530;470
"937";"1. Random";406;93;313;480;520
"938";"6. Biased  coin";413;110;303;501;500
"939";"2. Neyman known";420;93;327;459;541
"940";"3. RSIHR Known";444;70;374;368;632
"941";"4. Rosenberger known";548;26;522;130;870
"942";"5. Optimal adjusted";392;116;276;546;454
"943";"1. Random";408;88;320;478;522
"944";"6. Biased  coin";391;90;301;499;501
"945";"2. Neyman known";394;84;310;464;536
"946";"3. RSIHR Known";430;74;356;390;610
"947";"4. Rosenberger known";524;33;491;152;848
"948";"5. Optimal adjusted";384;99;285;518;482
"949";"1. Random";406;109;297;507;493
"950";"6. Biased  coin";399;110;289;501;500
"951";"2. Neyman known";399;97;302;470;530
"952";"3. RSIHR Known";455;81;374;358;642
"953";"4. Rosenberger known";550;27;523;126;874
"954";"5. Optimal adjusted";391;109;282;522;478
"955";"1. Random";382;89;293;489;511
"956";"6. Biased  coin";382;98;284;500;500
"957";"2. Neyman known";394;72;322;439;561
"958";"3. RSIHR Known";430;62;368;359;641
"959";"4. Rosenberger known";520;19;501;137;863
"960";"5. Optimal adjusted";366;87;279;525;475
"961";"1. Random";378;79;299;482;518
"962";"6. Biased  coin";371;96;275;500;500
"963";"2. Neyman known";388;93;295;482;518
"964";"3. RSIHR Known";432;60;372;346;654
"965";"4. Rosenberger known";500;25;475;152;848
"966";"5. Optimal adjusted";357;106;251;566;434
"967";"1. Random";387;82;305;499;501
"968";"6. Biased  coin";371;84;287;500;500
"969";"2. Neyman known";403;88;315;453;547
"970";"3. RSIHR Known";445;77;368;384;616
"971";"4. Rosenberger known";532;34;498;155;845
"972";"5. Optimal adjusted";375;110;265;562;438
"973";"1. Random";382;93;289;495;505
"974";"6. Biased  coin";383;94;289;502;499
"975";"2. Neyman known";402;94;308;446;554
"976";"3. RSIHR Known";454;71;383;351;649
"977";"4. Rosenberger known";520;35;485;164;836
"978";"5. Optimal adjusted";387;114;273;530;470
"979";"1. Random";397;116;281;509;491
"980";"6. Biased  coin";408;105;303;501;500
"981";"2. Neyman known";436;92;344;420;580
"982";"3. RSIHR Known";458;83;375;349;651
"983";"4. Rosenberger known";536;31;505;134;866
"984";"5. Optimal adjusted";379;116;263;544;456
"985";"1. Random";443;115;328;476;524
"986";"6. Biased  coin";409;105;304;501;500
"987";"2. Neyman known";453;108;345;430;570
"988";"3. RSIHR Known";452;72;380;345;655
"989";"4. Rosenberger known";552;34;518;133;867
"990";"5. Optimal adjusted";426;140;286;540;460
"991";"1. Random";388;89;299;493;507
"992";"6. Biased  coin";402;112;290;504;500
"993";"2. Neyman known";433;84;349;434;566
"994";"3. RSIHR Known";446;76;370;386;614
"995";"4. Rosenberger known";553;27;526;147;853
"996";"5. Optimal adjusted";393;108;285;551;449
"997";"1. Random";388;105;283;520;480
"998";"6. Biased  coin";390;92;298;502;499
"999";"2. Neyman known";420;94;326;442;558
"1000";"3. RSIHR Known";447;76;371;380;620
"1001";"4. Rosenberger known";521;22;499;146;854
"1002";"5. Optimal adjusted";402;118;284;536;464
"1003";"1. Random";413;109;304;485;515
"1004";"6. Biased  coin";426;115;311;503;500
"1005";"2. Neyman known";439;112;327;457;543
"1006";"3. RSIHR Known";452;76;376;373;627
"1007";"4. Rosenberger known";538;30;508;145;855
"1008";"5. Optimal adjusted";395;101;294;507;493
"1009";"1. Random";397;115;282;519;481
"1010";"6. Biased  coin";404;113;291;500;501
"1011";"2. Neyman known";426;102;324;441;559
"1012";"3. RSIHR Known";442;82;360;393;607
"1013";"4. Rosenberger known";505;26;479;154;846
"1014";"5. Optimal adjusted";354;115;239;564;436
"1015";"1. Random";399;118;281;529;471
"1016";"6. Biased  coin";423;109;314;501;500
"1017";"2. Neyman known";457;99;358;435;565
"1018";"3. RSIHR Known";428;74;354;384;616
"1019";"4. Rosenberger known";552;32;520;145;855
"1020";"5. Optimal adjusted";404;113;291;538;462
"1021";"1. Random";391;88;303;506;494
"1022";"6. Biased  coin";406;101;305;499;501
"1023";"2. Neyman known";396;81;315;478;522
"1024";"3. RSIHR Known";441;74;367;397;603
"1025";"4. Rosenberger known";545;23;522;155;845
"1026";"5. Optimal adjusted";372;93;279;539;461
"1027";"1. Random";405;97;308;504;496
"1028";"6. Biased  coin";418;105;313;499;502
"1029";"2. Neyman known";423;92;331;461;539
"1030";"3. RSIHR Known";451;77;374;377;623
"1031";"4. Rosenberger known";539;33;506;160;840
"1032";"5. Optimal adjusted";381;108;273;531;469
"1033";"1. Random";417;101;316;498;502
"1034";"6. Biased  coin";421;109;312;501;500
"1035";"2. Neyman known";419;80;339;449;551
"1036";"3. RSIHR Known";473;71;402;345;655
"1037";"4. Rosenberger known";571;22;549;122;878
"1038";"5. Optimal adjusted";396;105;291;557;443
"1039";"1. Random";402;97;305;493;507
"1040";"6. Biased  coin";408;111;297;504;499
"1041";"2. Neyman known";390;76;314;435;565
"1042";"3. RSIHR Known";444;68;376;362;638
"1043";"4. Rosenberger known";532;26;506;139;861
"1044";"5. Optimal adjusted";405;116;289;516;484
"1045";"1. Random";406;113;293;499;501
"1046";"6. Biased  coin";391;95;296;499;501
"1047";"2. Neyman known";410;74;336;427;573
"1048";"3. RSIHR Known";459;78;381;351;649
"1049";"4. Rosenberger known";527;28;499;149;851
"1050";"5. Optimal adjusted";417;120;297;515;485
"1051";"1. Random";429;114;315;494;506
"1052";"6. Biased  coin";416;114;302;501;501
"1053";"2. Neyman known";450;89;361;419;581
"1054";"3. RSIHR Known";490;78;412;354;646
"1055";"4. Rosenberger known";560;33;527;148;852
"1056";"5. Optimal adjusted";410;124;286;539;461
"1057";"1. Random";403;104;299;495;505
"1058";"6. Biased  coin";378;100;278;500;500
"1059";"2. Neyman known";403;86;317;467;533
"1060";"3. RSIHR Known";448;73;375;350;650
"1061";"4. Rosenberger known";549;37;512;135;865
"1062";"5. Optimal adjusted";365;111;254;563;437
"1063";"1. Random";384;85;299;481;519
"1064";"6. Biased  coin";393;85;308;500;500
"1065";"2. Neyman known";442;83;359;434;566
"1066";"3. RSIHR Known";468;68;400;344;656
"1067";"4. Rosenberger known";548;24;524;130;870
"1068";"5. Optimal adjusted";388;92;296;511;489
"1069";"1. Random";397;99;298;491;509
"1070";"6. Biased  coin";404;93;311;500;500
"1071";"2. Neyman known";415;84;331;450;550
"1072";"3. RSIHR Known";448;79;369;377;623
"1073";"4. Rosenberger known";532;36;496;171;829
"1074";"5. Optimal adjusted";386;111;275;533;467
"1075";"1. Random";422;109;313;494;506
"1076";"6. Biased  coin";397;101;296;503;499
"1077";"2. Neyman known";408;89;319;467;533
"1078";"3. RSIHR Known";461;73;388;377;623
"1079";"4. Rosenberger known";557;40;517;159;841
"1080";"5. Optimal adjusted";380;110;270;544;456
"1081";"1. Random";395;91;304;491;509
"1082";"6. Biased  coin";395;100;295;501;500
"1083";"2. Neyman known";407;94;313;466;534
"1084";"3. RSIHR Known";460;85;375;381;619
"1085";"4. Rosenberger known";534;17;517;119;881
"1086";"5. Optimal adjusted";378;107;271;542;458
"1087";"1. Random";429;114;315;488;512
"1088";"6. Biased  coin";404;96;308;500;500
"1089";"2. Neyman known";436;94;342;436;564
"1090";"3. RSIHR Known";479;78;401;357;643
"1091";"4. Rosenberger known";565;34;531;141;859
"1092";"5. Optimal adjusted";415;109;306;508;492
"1093";"1. Random";403;104;299;495;505
"1094";"6. Biased  coin";386;94;292;498;502
"1095";"2. Neyman known";405;92;313;456;544
"1096";"3. RSIHR Known";432;70;362;376;624
"1097";"4. Rosenberger known";520;24;496;139;861
"1098";"5. Optimal adjusted";382;107;275;531;469
"1099";"1. Random";437;100;337;464;536
"1100";"6. Biased  coin";419;118;301;499;501
"1101";"2. Neyman known";434;104;330;471;529
"1102";"3. RSIHR Known";445;71;374;359;641
"1103";"4. Rosenberger known";538;28;510;123;877
"1104";"5. Optimal adjusted";381;116;265;556;444
"1105";"1. Random";354;88;266;521;479
"1106";"6. Biased  coin";401;104;297;500;501
"1107";"2. Neyman known";414;96;318;451;549
"1108";"3. RSIHR Known";435;67;368;350;650
"1109";"4. Rosenberger known";531;32;499;129;871
"1110";"5. Optimal adjusted";359;104;255;548;452
"1111";"1. Random";359;80;279;502;498
"1112";"6. Biased  coin";371;88;283;500;500
"1113";"2. Neyman known";405;85;320;450;550
"1114";"3. RSIHR Known";431;65;366;366;634
"1115";"4. Rosenberger known";515;28;487;161;839
"1116";"5. Optimal adjusted";386;94;292;499;501
"1117";"1. Random";386;92;294;497;503
"1118";"6. Biased  coin";393;97;296;500;500
"1119";"2. Neyman known";428;88;340;443;557
"1120";"3. RSIHR Known";453;71;382;359;641
"1121";"4. Rosenberger known";528;34;494;166;834
"1122";"5. Optimal adjusted";374;107;267;540;460
"1123";"1. Random";382;97;285;520;480
"1124";"6. Biased  coin";388;90;298;500;500
"1125";"2. Neyman known";399;68;331;434;566
"1126";"3. RSIHR Known";441;71;370;372;628
"1127";"4. Rosenberger known";533;21;512;127;873
"1128";"5. Optimal adjusted";375;104;271;536;464
"1129";"1. Random";382;83;299;500;500
"1130";"6. Biased  coin";347;74;273;499;501
"1131";"2. Neyman known";410;77;333;421;579
"1132";"3. RSIHR Known";451;70;381;357;643
"1133";"4. Rosenberger known";532;24;508;134;866
"1134";"5. Optimal adjusted";357;84;273;507;493
"1135";"1. Random";408;109;299;505;495
"1136";"6. Biased  coin";410;105;305;501;500
"1137";"2. Neyman known";446;105;341;450;550
"1138";"3. RSIHR Known";450;67;383;370;630
"1139";"4. Rosenberger known";565;45;520;154;846
"1140";"5. Optimal adjusted";398;121;277;544;456
"1141";"1. Random";404;108;296;512;488
"1142";"6. Biased  coin";396;97;299;500;500
"1143";"2. Neyman known";416;78;338;420;580
"1144";"3. RSIHR Known";471;80;391;365;635
"1145";"4. Rosenberger known";541;31;510;151;849
"1146";"5. Optimal adjusted";379;114;265;567;433
"1147";"1. Random";375;91;284;508;492
"1148";"6. Biased  coin";381;87;294;500;500
"1149";"2. Neyman known";398;73;325;433;567
"1150";"3. RSIHR Known";442;78;364;373;627
"1151";"4. Rosenberger known";521;20;501;141;859
"1152";"5. Optimal adjusted";358;99;259;548;452
"1153";"1. Random";376;93;283;517;483
"1154";"6. Biased  coin";398;104;294;502;499
"1155";"2. Neyman known";429;88;341;443;557
"1156";"3. RSIHR Known";444;80;364;382;618
"1157";"4. Rosenberger known";510;14;496;140;860
"1158";"5. Optimal adjusted";388;107;281;526;474
"1159";"1. Random";414;125;289;510;490
"1160";"6. Biased  coin";401;106;295;501;499
"1161";"2. Neyman known";416;103;313;465;535
"1162";"3. RSIHR Known";421;75;346;397;603
"1163";"4. Rosenberger known";534;25;509;136;864
"1164";"5. Optimal adjusted";390;117;273;529;471
"1165";"1. Random";362;83;279;516;484
"1166";"6. Biased  coin";400;94;306;500;500
"1167";"2. Neyman known";412;91;321;444;556
"1168";"3. RSIHR Known";442;59;383;366;634
"1169";"4. Rosenberger known";534;30;504;147;853
"1170";"5. Optimal adjusted";383;113;270;541;459
"1171";"1. Random";409;100;309;485;515
"1172";"6. Biased  coin";412;107;305;500;500
"1173";"2. Neyman known";425;89;336;442;558
"1174";"3. RSIHR Known";468;73;395;343;657
"1175";"4. Rosenberger known";549;31;518;146;854
"1176";"5. Optimal adjusted";386;110;276;536;464
"1177";"1. Random";421;117;304;493;507
"1178";"6. Biased  coin";409;124;285;500;500
"1179";"2. Neyman known";416;107;309;456;544
"1180";"3. RSIHR Known";438;75;363;377;623
"1181";"4. Rosenberger known";509;25;484;153;847
"1182";"5. Optimal adjusted";371;102;269;544;456
"1183";"1. Random";421;108;313;499;501
"1184";"6. Biased  coin";412;111;301;500;500
"1185";"2. Neyman known";424;100;324;447;553
"1186";"3. RSIHR Known";459;78;381;369;631
"1187";"4. Rosenberger known";549;26;523;122;878
"1188";"5. Optimal adjusted";391;116;275;546;454
"1189";"1. Random";401;101;300;498;502
"1190";"6. Biased  coin";399;100;299;503;498
"1191";"2. Neyman known";401;88;313;484;516
"1192";"3. RSIHR Known";465;69;396;356;644
"1193";"4. Rosenberger known";538;25;513;137;863
"1194";"5. Optimal adjusted";372;99;273;535;465
"1195";"1. Random";387;101;286;498;502
"1196";"6. Biased  coin";380;93;287;499;501
"1197";"2. Neyman known";402;79;323;456;544
"1198";"3. RSIHR Known";436;75;361;379;621
"1199";"4. Rosenberger known";530;35;495;146;854
"1200";"5. Optimal adjusted";377;109;268;543;457
"1201";"1. Random";414;111;303;487;513
"1202";"6. Biased  coin";398;107;291;501;499
"1203";"2. Neyman known";413;98;315;482;518
"1204";"3. RSIHR Known";435;74;361;377;623
"1205";"4. Rosenberger known";536;28;508;133;867
"1206";"5. Optimal adjusted";369;106;263;542;458
"1207";"1. Random";364;89;275;497;503
"1208";"6. Biased  coin";381;100;281;500;500
"1209";"2. Neyman known";402;76;326;431;569
"1210";"3. RSIHR Known";446;73;373;365;635
"1211";"4. Rosenberger known";527;26;501;142;858
"1212";"5. Optimal adjusted";360;98;262;511;489
"1213";"1. Random";414;114;300;507;493
"1214";"6. Biased  coin";425;120;305;500;500
"1215";"2. Neyman known";426;110;316;468;532
"1216";"3. RSIHR Known";475;78;397;356;644
"1217";"4. Rosenberger known";566;32;534;127;873
"1218";"5. Optimal adjusted";399;125;274;552;448
"1219";"1. Random";386;93;293;511;489
"1220";"6. Biased  coin";389;103;286;502;499
"1221";"2. Neyman known";400;88;312;466;534
"1222";"3. RSIHR Known";425;68;357;371;629
"1223";"4. Rosenberger known";537;28;509;136;864
"1224";"5. Optimal adjusted";346;94;252;540;460
"1225";"1. Random";386;91;295;482;518
"1226";"6. Biased  coin";389;100;289;502;499
"1227";"2. Neyman known";421;83;338;427;573
"1228";"3. RSIHR Known";465;81;384;346;654
"1229";"4. Rosenberger known";520;34;486;153;847
"1230";"5. Optimal adjusted";376;113;263;543;457
"1231";"1. Random";380;112;268;512;488
"1232";"6. Biased  coin";394;104;290;501;500
"1233";"2. Neyman known";424;86;338;419;581
"1234";"3. RSIHR Known";443;76;367;373;627
"1235";"4. Rosenberger known";542;34;508;134;866
"1236";"5. Optimal adjusted";348;112;236;565;435
"1237";"1. Random";391;88;303;488;512
"1238";"6. Biased  coin";403;97;306;499;501
"1239";"2. Neyman known";405;79;326;443;557
"1240";"3. RSIHR Known";471;84;387;361;639
"1241";"4. Rosenberger known";549;34;515;136;864
"1242";"5. Optimal adjusted";407;119;288;518;482
"1243";"1. Random";397;104;293;498;502
"1244";"6. Biased  coin";399;97;302;501;499
"1245";"2. Neyman known";429;80;349;418;582
"1246";"3. RSIHR Known";440;73;367;379;621
"1247";"4. Rosenberger known";533;21;512;127;873
"1248";"5. Optimal adjusted";356;95;261;546;454
"1249";"1. Random";372;95;277;495;505
"1250";"6. Biased  coin";390;100;290;503;498
"1251";"2. Neyman known";414;95;319;450;550
"1252";"3. RSIHR Known";437;71;366;353;647
"1253";"4. Rosenberger known";513;28;485;149;851
"1254";"5. Optimal adjusted";358;110;248;541;459
"1255";"1. Random";394;103;291;477;523
"1256";"6. Biased  coin";406;110;296;500;500
"1257";"2. Neyman known";389;94;295;459;541
"1258";"3. RSIHR Known";424;92;332;402;598
"1259";"4. Rosenberger known";514;30;484;157;843
"1260";"5. Optimal adjusted";407;111;296;512;488
"1261";"1. Random";402;103;299;507;493
"1262";"6. Biased  coin";390;88;302;502;500
"1263";"2. Neyman known";421;85;336;450;550
"1264";"3. RSIHR Known";449;61;388;352;648
"1265";"4. Rosenberger known";537;21;516;128;872
"1266";"5. Optimal adjusted";381;105;276;533;467
"1267";"1. Random";395;96;299;487;513
"1268";"6. Biased  coin";397;111;286;500;500
"1269";"2. Neyman known";418;96;322;453;547
"1270";"3. RSIHR Known";430;73;357;367;633
"1271";"4. Rosenberger known";532;27;505;131;869
"1272";"5. Optimal adjusted";370;113;257;540;460
"1273";"1. Random";400;102;298;473;527
"1274";"6. Biased  coin";382;102;280;500;500
"1275";"2. Neyman known";401;87;314;432;568
"1276";"3. RSIHR Known";446;82;364;367;633
"1277";"4. Rosenberger known";515;27;488;138;862
"1278";"5. Optimal adjusted";355;120;235;557;443
"1279";"1. Random";385;100;285;501;499
"1280";"6. Biased  coin";386;93;293;500;500
"1281";"2. Neyman known";410;99;311;457;543
"1282";"3. RSIHR Known";434;71;363;363;637
"1283";"4. Rosenberger known";513;32;481;153;847
"1284";"5. Optimal adjusted";362;102;260;527;473
"1285";"1. Random";414;96;318;474;526
"1286";"6. Biased  coin";405;107;298;501;500
"1287";"2. Neyman known";445;93;352;423;577
"1288";"3. RSIHR Known";468;77;391;345;655
"1289";"4. Rosenberger known";564;25;539;123;877
"1290";"5. Optimal adjusted";421;111;310;506;494
"1291";"1. Random";411;108;303;494;506
"1292";"6. Biased  coin";413;111;302;500;501
"1293";"2. Neyman known";417;92;325;441;559
"1294";"3. RSIHR Known";446;74;372;362;638
"1295";"4. Rosenberger known";538;23;515;141;859
"1296";"5. Optimal adjusted";411;116;295;517;483
"1297";"1. Random";388;105;283;516;484
"1298";"6. Biased  coin";413;111;302;500;501
"1299";"2. Neyman known";402;88;314;449;551
"1300";"3. RSIHR Known";454;78;376;361;639
"1301";"4. Rosenberger known";519;22;497;141;859
"1302";"5. Optimal adjusted";396;110;286;523;477
"1303";"1. Random";428;100;328;495;505
"1304";"6. Biased  coin";398;97;301;499;503
"1305";"2. Neyman known";435;86;349;451;549
"1306";"3. RSIHR Known";460;78;382;348;652
"1307";"4. Rosenberger known";552;23;529;132;868
"1308";"5. Optimal adjusted";381;102;279;555;445
"1309";"1. Random";404;110;294;496;504
"1310";"6. Biased  coin";413;114;299;500;501
"1311";"2. Neyman known";433;101;332;435;565
"1312";"3. RSIHR Known";457;77;380;366;634
"1313";"4. Rosenberger known";549;37;512;145;855
"1314";"5. Optimal adjusted";395;121;274;522;478
"1315";"1. Random";417;106;311;506;494
"1316";"6. Biased  coin";391;92;299;499;501
"1317";"2. Neyman known";443;94;349;436;564
"1318";"3. RSIHR Known";473;91;382;379;621
"1319";"4. Rosenberger known";556;28;528;133;867
"1320";"5. Optimal adjusted";396;111;285;521;479
"1321";"1. Random";393;95;298;493;507
"1322";"6. Biased  coin";393;99;294;503;500
"1323";"2. Neyman known";417;86;331;440;560
"1324";"3. RSIHR Known";453;74;379;336;664
"1325";"4. Rosenberger known";518;24;494;144;856
"1326";"5. Optimal adjusted";363;107;256;550;450
"1327";"1. Random";402;114;288;521;479
"1328";"6. Biased  coin";394;102;292;499;501
"1329";"2. Neyman known";409;92;317;434;566
"1330";"3. RSIHR Known";438;74;364;363;637
"1331";"4. Rosenberger known";522;21;501;122;878
"1332";"5. Optimal adjusted";371;106;265;540;460
"1333";"1. Random";412;120;292;520;480
"1334";"6. Biased  coin";409;110;299;501;500
"1335";"2. Neyman known";428;100;328;442;558
"1336";"3. RSIHR Known";456;81;375;379;621
"1337";"4. Rosenberger known";527;27;500;145;855
"1338";"5. Optimal adjusted";389;115;274;529;471
"1339";"1. Random";385;94;291;492;508
"1340";"6. Biased  coin";385;92;293;498;502
"1341";"2. Neyman known";394;85;309;455;545
"1342";"3. RSIHR Known";431;53;378;340;660
"1343";"4. Rosenberger known";525;28;497;155;845
"1344";"5. Optimal adjusted";395;101;294;517;483
"1345";"1. Random";411;101;310;466;534
"1346";"6. Biased  coin";381;97;284;500;500
"1347";"2. Neyman known";409;92;317;447;553
"1348";"3. RSIHR Known";447;73;374;370;630
"1349";"4. Rosenberger known";533;34;499;163;837
"1350";"5. Optimal adjusted";398;107;291;520;480
"1351";"1. Random";370;98;272;516;484
"1352";"6. Biased  coin";402;104;298;501;499
"1353";"2. Neyman known";381;88;293;460;540
"1354";"3. RSIHR Known";419;60;359;371;629
"1355";"4. Rosenberger known";505;26;479;140;860
"1356";"5. Optimal adjusted";378;100;278;513;487
"1357";"1. Random";446;111;335;454;546
"1358";"6. Biased  coin";417;116;301;498;502
"1359";"2. Neyman known";434;94;340;440;560
"1360";"3. RSIHR Known";480;83;397;360;640
"1361";"4. Rosenberger known";554;27;527;148;852
"1362";"5. Optimal adjusted";390;107;283;531;469
"1363";"1. Random";411;95;316;480;520
"1364";"6. Biased  coin";392;106;286;501;500
"1365";"2. Neyman known";391;90;301;474;526
"1366";"3. RSIHR Known";442;75;367;382;618
"1367";"4. Rosenberger known";538;39;499;138;862
"1368";"5. Optimal adjusted";374;106;268;529;471
"1369";"1. Random";392;106;286;508;492
"1370";"6. Biased  coin";415;116;299;503;500
"1371";"2. Neyman known";410;101;309;458;542
"1372";"3. RSIHR Known";453;77;376;357;643
"1373";"4. Rosenberger known";536;42;494;165;835
"1374";"5. Optimal adjusted";374;107;267;528;472
"1375";"1. Random";402;108;294;521;479
"1376";"6. Biased  coin";399;95;304;499;502
"1377";"2. Neyman known";437;91;346;436;564
"1378";"3. RSIHR Known";459;75;384;378;622
"1379";"4. Rosenberger known";570;39;531;150;850
"1380";"5. Optimal adjusted";384;105;279;538;462
"1381";"1. Random";424;118;306;493;507
"1382";"6. Biased  coin";388;100;288;502;499
"1383";"2. Neyman known";423;99;324;445;555
"1384";"3. RSIHR Known";429;65;364;361;639
"1385";"4. Rosenberger known";505;28;477;159;841
"1386";"5. Optimal adjusted";377;129;248;572;428
"1387";"1. Random";422;110;312;499;501
"1388";"6. Biased  coin";407;97;310;500;500
"1389";"2. Neyman known";417;94;323;464;536
"1390";"3. RSIHR Known";466;80;386;371;629
"1391";"4. Rosenberger known";554;29;525;147;853
"1392";"5. Optimal adjusted";399;94;305;525;475
"1393";"1. Random";432;110;322;494;506
"1394";"6. Biased  coin";389;110;279;501;499
"1395";"2. Neyman known";432;105;327;449;551
"1396";"3. RSIHR Known";455;85;370;373;627
"1397";"4. Rosenberger known";530;36;494;142;858
"1398";"5. Optimal adjusted";369;118;251;556;444
"1399";"1. Random";415;89;326;470;530
"1400";"6. Biased  coin";409;99;310;500;500
"1401";"2. Neyman known";428;83;345;429;571
"1402";"3. RSIHR Known";463;74;389;375;625
"1403";"4. Rosenberger known";545;26;519;140;860
"1404";"5. Optimal adjusted";372;111;261;559;441
"1405";"1. Random";382;94;288;507;493
"1406";"6. Biased  coin";387;86;301;500;500
"1407";"2. Neyman known";408;67;341;430;570
"1408";"3. RSIHR Known";435;72;363;383;617
"1409";"4. Rosenberger known";521;19;502;145;855
"1410";"5. Optimal adjusted";358;98;260;551;449
"1411";"1. Random";403;107;296;504;496
"1412";"6. Biased  coin";398;100;298;500;501
"1413";"2. Neyman known";424;89;335;452;548
"1414";"3. RSIHR Known";457;63;394;344;656
"1415";"4. Rosenberger known";538;25;513;140;860
"1416";"5. Optimal adjusted";355;103;252;556;444
"1417";"1. Random";387;98;289;498;502
"1418";"6. Biased  coin";406;106;300;501;500
"1419";"2. Neyman known";426;83;343;418;582
"1420";"3. RSIHR Known";444;71;373;353;647
"1421";"4. Rosenberger known";537;27;510;146;854
"1422";"5. Optimal adjusted";378;107;271;541;459
"1423";"1. Random";396;110;286;504;496
"1424";"6. Biased  coin";398;109;289;500;500
"1425";"2. Neyman known";429;92;337;431;569
"1426";"3. RSIHR Known";452;81;371;360;640
"1427";"4. Rosenberger known";538;29;509;118;882
"1428";"5. Optimal adjusted";402;117;285;521;479
"1429";"1. Random";427;129;298;504;496
"1430";"6. Biased  coin";408;108;300;502;499
"1431";"2. Neyman known";423;115;308;475;525
"1432";"3. RSIHR Known";453;92;361;398;602
"1433";"4. Rosenberger known";544;35;509;145;855
"1434";"5. Optimal adjusted";398;104;294;509;491
"1435";"1. Random";381;97;284;493;507
"1436";"6. Biased  coin";390;91;299;500;500
"1437";"2. Neyman known";443;90;353;437;563
"1438";"3. RSIHR Known";430;73;357;377;623
"1439";"4. Rosenberger known";515;29;486;172;828
"1440";"5. Optimal adjusted";364;96;268;522;478
"1441";"1. Random";432;114;318;490;510
"1442";"6. Biased  coin";432;123;309;501;499
"1443";"2. Neyman known";445;102;343;458;542
"1444";"3. RSIHR Known";472;79;393;370;630
"1445";"4. Rosenberger known";563;36;527;149;851
"1446";"5. Optimal adjusted";413;122;291;545;455
"1447";"1. Random";376;105;271;523;477
"1448";"6. Biased  coin";394;98;296;499;501
"1449";"2. Neyman known";403;91;312;467;533
"1450";"3. RSIHR Known";449;72;377;358;642
"1451";"4. Rosenberger known";529;23;506;130;870
"1452";"5. Optimal adjusted";379;113;266;528;472
"1453";"1. Random";378;79;299;490;510
"1454";"6. Biased  coin";381;95;286;502;499
"1455";"2. Neyman known";400;84;316;466;534
"1456";"3. RSIHR Known";430;80;350;390;610
"1457";"4. Rosenberger known";538;37;501;167;833
"1458";"5. Optimal adjusted";377;112;265;539;461
"1459";"1. Random";378;94;284;500;500
"1460";"6. Biased  coin";391;101;290;501;501
"1461";"2. Neyman known";420;95;325;430;570
"1462";"3. RSIHR Known";433;69;364;374;626
"1463";"4. Rosenberger known";519;35;484;148;852
"1464";"5. Optimal adjusted";377;112;265;546;454
"1465";"1. Random";408;99;309;488;512
"1466";"6. Biased  coin";383;89;294;499;501
"1467";"2. Neyman known";445;95;350;447;553
"1468";"3. RSIHR Known";460;75;385;362;638
"1469";"4. Rosenberger known";541;17;524;114;886
"1470";"5. Optimal adjusted";397;112;285;536;464
"1471";"1. Random";404;103;301;489;511
"1472";"6. Biased  coin";386;101;285;500;500
"1473";"2. Neyman known";415;98;317;458;542
"1474";"3. RSIHR Known";438;92;346;367;633
"1475";"4. Rosenberger known";533;30;503;135;865
"1476";"5. Optimal adjusted";379;119;260;554;446
"1477";"1. Random";389;95;294;517;483
"1478";"6. Biased  coin";385;89;296;503;499
"1479";"2. Neyman known";421;65;356;405;595
"1480";"3. RSIHR Known";469;70;399;361;639
"1481";"4. Rosenberger known";553;23;530;139;861
"1482";"5. Optimal adjusted";396;110;286;534;466
"1483";"1. Random";373;92;281;530;470
"1484";"6. Biased  coin";377;84;293;500;500
"1485";"2. Neyman known";427;89;338;454;546
"1486";"3. RSIHR Known";444;52;392;350;650
"1487";"4. Rosenberger known";541;21;520;144;856
"1488";"5. Optimal adjusted";375;99;276;545;455
"1489";"1. Random";381;96;285;498;502
"1490";"6. Biased  coin";400;108;292;503;500
"1491";"2. Neyman known";396;91;305;463;537
"1492";"3. RSIHR Known";435;64;371;366;634
"1493";"4. Rosenberger known";539;21;518;121;879
"1494";"5. Optimal adjusted";376;103;273;534;466
"1495";"1. Random";402;119;283;513;487
"1496";"6. Biased  coin";406;115;291;500;501
"1497";"2. Neyman known";406;103;303;463;537
"1498";"3. RSIHR Known";466;87;379;359;641
"1499";"4. Rosenberger known";538;37;501;149;851
"1500";"5. Optimal adjusted";396;126;270;554;446
"1501";"1. Random";394;99;295;499;501
"1502";"6. Biased  coin";407;111;296;504;498
"1503";"2. Neyman known";394;84;310;452;548
"1504";"3. RSIHR Known";432;75;357;378;622
"1505";"4. Rosenberger known";532;35;497;160;840
"1506";"5. Optimal adjusted";393;105;288;510;490
"1507";"1. Random";409;90;319;464;536
"1508";"6. Biased  coin";412;109;303;503;500
"1509";"2. Neyman known";412;88;324;451;549
"1510";"3. RSIHR Known";465;78;387;366;634
"1511";"4. Rosenberger known";555;34;521;153;847
"1512";"5. Optimal adjusted";383;113;270;568;432
"1513";"1. Random";359;89;270;509;491
"1514";"6. Biased  coin";370;93;277;500;500
"1515";"2. Neyman known";385;85;300;469;531
"1516";"3. RSIHR Known";444;67;377;346;654
"1517";"4. Rosenberger known";531;24;507;133;867
"1518";"5. Optimal adjusted";370;108;262;545;455
"1519";"1. Random";389;98;291;487;513
"1520";"6. Biased  coin";390;101;289;500;500
"1521";"2. Neyman known";399;92;307;456;544
"1522";"3. RSIHR Known";426;77;349;382;618
"1523";"4. Rosenberger known";506;32;474;157;843
"1524";"5. Optimal adjusted";366;107;259;541;459
"1525";"1. Random";410;102;308;481;519
"1526";"6. Biased  coin";411;107;304;504;498
"1527";"2. Neyman known";428;108;320;491;509
"1528";"3. RSIHR Known";472;85;387;369;631
"1529";"4. Rosenberger known";549;32;517;138;862
"1530";"5. Optimal adjusted";369;112;257;543;457
"1531";"1. Random";395;112;283;521;479
"1532";"6. Biased  coin";422;105;317;500;501
"1533";"2. Neyman known";421;86;335;445;555
"1534";"3. RSIHR Known";469;73;396;350;650
"1535";"4. Rosenberger known";543;22;521;145;855
"1536";"5. Optimal adjusted";407;121;286;541;459
"1537";"1. Random";406;104;302;479;521
"1538";"6. Biased  coin";409;115;294;500;500
"1539";"2. Neyman known";415;102;313;463;537
"1540";"3. RSIHR Known";438;69;369;364;636
"1541";"4. Rosenberger known";538;29;509;145;855
"1542";"5. Optimal adjusted";384;122;262;546;454
"1543";"1. Random";402;108;294;506;494
"1544";"6. Biased  coin";411;109;302;500;500
"1545";"2. Neyman known";418;97;321;468;532
"1546";"3. RSIHR Known";455;73;382;355;645
"1547";"4. Rosenberger known";526;23;503;147;853
"1548";"5. Optimal adjusted";369;117;252;562;438
"1549";"1. Random";379;107;272;518;482
"1550";"6. Biased  coin";394;105;289;499;501
"1551";"2. Neyman known";406;99;307;447;553
"1552";"3. RSIHR Known";455;85;370;371;629
"1553";"4. Rosenberger known";523;29;494;140;860
"1554";"5. Optimal adjusted";372;119;253;545;455
"1555";"1. Random";434;113;321;468;532
"1556";"6. Biased  coin";419;118;301;501;499
"1557";"2. Neyman known";445;110;335;434;566
"1558";"3. RSIHR Known";460;79;381;362;638
"1559";"4. Rosenberger known";545;36;509;155;845
"1560";"5. Optimal adjusted";403;124;279;534;466
"1561";"1. Random";399;109;290;485;515
"1562";"6. Biased  coin";398;116;282;500;501
"1563";"2. Neyman known";418;91;327;462;538
"1564";"3. RSIHR Known";455;95;360;381;619
"1565";"4. Rosenberger known";507;27;480;142;858
"1566";"5. Optimal adjusted";393;117;276;539;461
"1567";"1. Random";393;103;290;516;484
"1568";"6. Biased  coin";432;119;313;500;501
"1569";"2. Neyman known";444;102;342;451;549
"1570";"3. RSIHR Known";471;83;388;363;637
"1571";"4. Rosenberger known";565;30;535;133;867
"1572";"5. Optimal adjusted";390;110;280;530;470
"1573";"1. Random";402;95;307;494;506
"1574";"6. Biased  coin";394;99;295;502;500
"1575";"2. Neyman known";402;86;316;469;531
"1576";"3. RSIHR Known";434;75;359;388;612
"1577";"4. Rosenberger known";537;27;510;138;862
"1578";"5. Optimal adjusted";382;104;278;546;454
"1579";"1. Random";402;97;305;503;497
"1580";"6. Biased  coin";398;97;301;501;500
"1581";"2. Neyman known";422;88;334;442;558
"1582";"3. RSIHR Known";430;72;358;374;626
"1583";"4. Rosenberger known";550;22;528;118;882
"1584";"5. Optimal adjusted";367;117;250;593;407
"1585";"1. Random";404;100;304;491;509
"1586";"6. Biased  coin";399;98;301;499;501
"1587";"2. Neyman known";406;102;304;487;513
"1588";"3. RSIHR Known";453;77;376;363;637
"1589";"4. Rosenberger known";537;37;500;148;852
"1590";"5. Optimal adjusted";361;112;249;559;441
"1591";"1. Random";441;95;346;466;534
"1592";"6. Biased  coin";412;96;316;501;500
"1593";"2. Neyman known";439;86;353;435;565
"1594";"3. RSIHR Known";436;71;365;381;619
"1595";"4. Rosenberger known";551;28;523;153;847
"1596";"5. Optimal adjusted";411;107;304;534;466
"1597";"1. Random";392;100;292;486;514
"1598";"6. Biased  coin";374;102;272;502;501
"1599";"2. Neyman known";389;86;303;472;528
"1600";"3. RSIHR Known";434;71;363;370;630
"1601";"4. Rosenberger known";511;24;487;133;867
"1602";"5. Optimal adjusted";372;105;267;531;469
"1603";"1. Random";391;116;275;517;483
"1604";"6. Biased  coin";414;114;300;501;500
"1605";"2. Neyman known";414;108;306;471;529
"1606";"3. RSIHR Known";442;80;362;381;619
"1607";"4. Rosenberger known";536;24;512;141;859
"1608";"5. Optimal adjusted";387;118;269;537;463
"1609";"1. Random";405;111;294;479;521
"1610";"6. Biased  coin";396;114;282;500;500
"1611";"2. Neyman known";408;82;326;462;538
"1612";"3. RSIHR Known";439;82;357;385;615
"1613";"4. Rosenberger known";521;24;497;143;857
"1614";"5. Optimal adjusted";376;103;273;534;466
"1615";"1. Random";414;113;301;488;512
"1616";"6. Biased  coin";413;106;307;501;499
"1617";"2. Neyman known";409;108;301;489;511
"1618";"3. RSIHR Known";442;83;359;367;633
"1619";"4. Rosenberger known";531;31;500;154;846
"1620";"5. Optimal adjusted";390;116;274;539;461
"1621";"1. Random";357;80;277;503;497
"1622";"6. Biased  coin";381;100;281;500;500
"1623";"2. Neyman known";434;87;347;440;560
"1624";"3. RSIHR Known";425;66;359;378;622
"1625";"4. Rosenberger known";536;22;514;135;865
"1626";"5. Optimal adjusted";357;94;263;541;459
"1627";"1. Random";418;104;314;484;516
"1628";"6. Biased  coin";395;106;289;500;500
"1629";"2. Neyman known";408;98;310;474;526
"1630";"3. RSIHR Known";481;82;399;344;656
"1631";"4. Rosenberger known";547;27;520;136;864
"1632";"5. Optimal adjusted";397;105;292;522;478
"1633";"1. Random";402;108;294;510;490
"1634";"6. Biased  coin";417;103;314;500;501
"1635";"2. Neyman known";427;95;332;445;555
"1636";"3. RSIHR Known";461;78;383;368;632
"1637";"4. Rosenberger known";521;26;495;161;839
"1638";"5. Optimal adjusted";392;106;286;538;462
"1639";"1. Random";391;93;298;502;498
"1640";"6. Biased  coin";395;102;293;500;501
"1641";"2. Neyman known";402;88;314;449;551
"1642";"3. RSIHR Known";454;79;375;362;638
"1643";"4. Rosenberger known";540;34;506;144;856
"1644";"5. Optimal adjusted";370;102;268;550;450
"1645";"1. Random";425;110;315;468;532
"1646";"6. Biased  coin";398;103;295;499;501
"1647";"2. Neyman known";438;108;330;441;559
"1648";"3. RSIHR Known";462;84;378;365;635
"1649";"4. Rosenberger known";548;34;514;135;865
"1650";"5. Optimal adjusted";387;111;276;542;458
"1651";"1. Random";413;104;309;511;489
"1652";"6. Biased  coin";397;98;299;500;501
"1653";"2. Neyman known";435;89;346;431;569
"1654";"3. RSIHR Known";444;76;368;379;621
"1655";"4. Rosenberger known";549;35;514;150;850
"1656";"5. Optimal adjusted";376;106;270;542;458
"1657";"1. Random";366;93;273;518;482
"1658";"6. Biased  coin";393;91;302;502;499
"1659";"2. Neyman known";400;74;326;427;573
"1660";"3. RSIHR Known";442;57;385;347;653
"1661";"4. Rosenberger known";521;21;500;143;857
"1662";"5. Optimal adjusted";378;97;281;535;465
"1663";"1. Random";388;120;268;535;465
"1664";"6. Biased  coin";387;109;278;500;500
"1665";"2. Neyman known";407;89;318;452;548
"1666";"3. RSIHR Known";436;83;353;395;605
"1667";"4. Rosenberger known";529;26;503;129;871
"1668";"5. Optimal adjusted";364;110;254;544;456
"1669";"1. Random";406;106;300;503;497
"1670";"6. Biased  coin";407;101;306;497;503
"1671";"2. Neyman known";410;101;309;472;528
"1672";"3. RSIHR Known";450;72;378;376;624
"1673";"4. Rosenberger known";569;35;534;146;854
"1674";"5. Optimal adjusted";396;117;279;553;447
"1675";"1. Random";397;100;297;503;497
"1676";"6. Biased  coin";388;95;293;501;500
"1677";"2. Neyman known";404;84;320;453;547
"1678";"3. RSIHR Known";441;76;365;393;607
"1679";"4. Rosenberger known";525;21;504;139;861
"1680";"5. Optimal adjusted";358;93;265;541;459
"1681";"1. Random";426;107;319;491;509
"1682";"6. Biased  coin";409;105;304;499;502
"1683";"2. Neyman known";460;102;358;433;567
"1684";"3. RSIHR Known";451;74;377;368;632
"1685";"4. Rosenberger known";558;29;529;136;864
"1686";"5. Optimal adjusted";382;123;259;562;438
"1687";"1. Random";386;91;295;507;493
"1688";"6. Biased  coin";388;101;287;500;500
"1689";"2. Neyman known";405;81;324;446;554
"1690";"3. RSIHR Known";444;58;386;351;649
"1691";"4. Rosenberger known";516;24;492;146;854
"1692";"5. Optimal adjusted";350;86;264;511;489
"1693";"1. Random";396;91;305;508;492
"1694";"6. Biased  coin";387;94;293;502;499
"1695";"2. Neyman known";406;92;314;459;541
"1696";"3. RSIHR Known";453;79;374;376;624
"1697";"4. Rosenberger known";546;33;513;147;853
"1698";"5. Optimal adjusted";394;108;286;532;468
"1699";"1. Random";416;112;304;509;491
"1700";"6. Biased  coin";411;109;302;501;500
"1701";"2. Neyman known";407;83;324;446;554
"1702";"3. RSIHR Known";463;75;388;359;641
"1703";"4. Rosenberger known";555;37;518;155;845
"1704";"5. Optimal adjusted";385;99;286;540;460
"1705";"1. Random";375;100;275;519;481
"1706";"6. Biased  coin";379;99;280;500;500
"1707";"2. Neyman known";409;84;325;433;567
"1708";"3. RSIHR Known";442;79;363;371;629
"1709";"4. Rosenberger known";528;24;504;136;864
"1710";"5. Optimal adjusted";375;98;277;510;490
"1711";"1. Random";419;116;303;518;482
"1712";"6. Biased  coin";418;111;307;500;501
"1713";"2. Neyman known";437;95;342;439;561
"1714";"3. RSIHR Known";463;91;372;389;611
"1715";"4. Rosenberger known";558;34;524;146;854
"1716";"5. Optimal adjusted";399;119;280;559;441
"1717";"1. Random";379;111;268;540;460
"1718";"6. Biased  coin";372;102;270;502;499
"1719";"2. Neyman known";412;107;305;474;526
"1720";"3. RSIHR Known";449;88;361;373;627
"1721";"4. Rosenberger known";531;37;494;147;853
"1722";"5. Optimal adjusted";385;112;273;524;476
"1723";"1. Random";408;109;299;500;500
"1724";"6. Biased  coin";394;99;295;499;501
"1725";"2. Neyman known";422;84;338;431;569
"1726";"3. RSIHR Known";462;68;394;341;659
"1727";"4. Rosenberger known";537;40;497;159;841
"1728";"5. Optimal adjusted";393;99;294;522;478
"1729";"1. Random";411;123;288;516;484
"1730";"6. Biased  coin";387;98;289;500;500
"1731";"2. Neyman known";412;97;315;466;534
"1732";"3. RSIHR Known";430;81;349;382;618
"1733";"4. Rosenberger known";522;29;493;163;837
"1734";"5. Optimal adjusted";390;108;282;532;468
"1735";"1. Random";387;97;290;489;511
"1736";"6. Biased  coin";395;99;296;499;501
"1737";"2. Neyman known";423;99;324;450;550
"1738";"3. RSIHR Known";433;82;351;386;614
"1739";"4. Rosenberger known";547;29;518;122;878
"1740";"5. Optimal adjusted";367;99;268;536;464
"1741";"1. Random";399;95;304;487;513
"1742";"6. Biased  coin";383;99;284;501;500
"1743";"2. Neyman known";417;86;331;443;557
"1744";"3. RSIHR Known";478;79;399;356;644
"1745";"4. Rosenberger known";542;22;520;122;878
"1746";"5. Optimal adjusted";409;122;287;549;451
"1747";"1. Random";396;89;307;507;493
"1748";"6. Biased  coin";400;101;299;500;500
"1749";"2. Neyman known";453;96;357;448;552
"1750";"3. RSIHR Known";465;83;382;374;626
"1751";"4. Rosenberger known";548;22;526;139;861
"1752";"5. Optimal adjusted";386;104;282;521;479
"1753";"1. Random";400;108;292;503;497
"1754";"6. Biased  coin";392;105;287;500;500
"1755";"2. Neyman known";427;99;328;467;533
"1756";"3. RSIHR Known";455;81;374;360;640
"1757";"4. Rosenberger known";541;30;511;148;852
"1758";"5. Optimal adjusted";391;114;277;538;462
"1759";"1. Random";421;106;315;489;511
"1760";"6. Biased  coin";409;108;301;500;500
"1761";"2. Neyman known";437;94;343;429;571
"1762";"3. RSIHR Known";463;70;393;359;641
"1763";"4. Rosenberger known";546;29;517;151;849
"1764";"5. Optimal adjusted";405;110;295;503;497
"1765";"1. Random";397;104;293;499;501
"1766";"6. Biased  coin";375;89;286;500;500
"1767";"2. Neyman known";400;82;318;466;534
"1768";"3. RSIHR Known";436;79;357;397;603
"1769";"4. Rosenberger known";515;28;487;160;840
"1770";"5. Optimal adjusted";381;101;280;524;476
"1771";"1. Random";422;111;311;527;473
"1772";"6. Biased  coin";409;90;319;501;501
"1773";"2. Neyman known";439;84;355;432;568
"1774";"3. RSIHR Known";463;75;388;369;631
"1775";"4. Rosenberger known";561;24;537;132;868
"1776";"5. Optimal adjusted";386;109;277;554;446
"1777";"1. Random";407;101;306;498;502
"1778";"6. Biased  coin";380;97;283;500;501
"1779";"2. Neyman known";418;81;337;427;573
"1780";"3. RSIHR Known";453;79;374;352;648
"1781";"4. Rosenberger known";544;28;516;138;862
"1782";"5. Optimal adjusted";390;104;286;549;451
"1783";"1. Random";377;98;279;519;481
"1784";"6. Biased  coin";386;92;294;500;500
"1785";"2. Neyman known";403;78;325;449;551
"1786";"3. RSIHR Known";456;74;382;355;645
"1787";"4. Rosenberger known";556;23;533;125;875
"1788";"5. Optimal adjusted";398;105;293;521;479
"1789";"1. Random";416;118;298;513;487
"1790";"6. Biased  coin";423;117;306;503;499
"1791";"2. Neyman known";438;96;342;428;572
"1792";"3. RSIHR Known";436;69;367;383;617
"1793";"4. Rosenberger known";546;38;508;157;843
"1794";"5. Optimal adjusted";404;121;283;525;475
"1795";"1. Random";418;95;323;472;528
"1796";"6. Biased  coin";389;101;288;501;499
"1797";"2. Neyman known";424;94;330;448;552
"1798";"3. RSIHR Known";472;78;394;366;634
"1799";"4. Rosenberger known";558;38;520;141;859
"1800";"5. Optimal adjusted";404;129;275;535;465
"1801";"1. Random";388;92;296;495;505
"1802";"6. Biased  coin";382;89;293;502;498
"1803";"2. Neyman known";395;82;313;456;544
"1804";"3. RSIHR Known";440;58;382;362;638
"1805";"4. Rosenberger known";528;21;507;140;860
"1806";"5. Optimal adjusted";381;92;289;506;494
"1807";"1. Random";393;92;301;489;511
"1808";"6. Biased  coin";394;83;311;501;499
"1809";"2. Neyman known";420;81;339;436;564
"1810";"3. RSIHR Known";456;69;387;371;629
"1811";"4. Rosenberger known";557;34;523;144;856
"1812";"5. Optimal adjusted";370;98;272;537;463
"1813";"1. Random";394;87;307;500;500
"1814";"6. Biased  coin";387;97;290;501;499
"1815";"2. Neyman known";424;91;333;462;538
"1816";"3. RSIHR Known";460;78;382;390;610
"1817";"4. Rosenberger known";554;20;534;126;874
"1818";"5. Optimal adjusted";392;88;304;513;487
"1819";"1. Random";411;109;302;500;500
"1820";"6. Biased  coin";408;100;308;502;499
"1821";"2. Neyman known";417;86;331;435;565
"1822";"3. RSIHR Known";457;68;389;351;649
"1823";"4. Rosenberger known";522;25;497;151;849
"1824";"5. Optimal adjusted";390;113;277;540;460
"1825";"1. Random";408;102;306;495;505
"1826";"6. Biased  coin";408;103;305;501;500
"1827";"2. Neyman known";417;85;332;455;545
"1828";"3. RSIHR Known";467;79;388;370;630
"1829";"4. Rosenberger known";549;27;522;143;857
"1830";"5. Optimal adjusted";392;116;276;536;464
"1831";"1. Random";421;113;308;514;486
"1832";"6. Biased  coin";425;114;311;502;499
"1833";"2. Neyman known";456;103;353;420;580
"1834";"3. RSIHR Known";465;81;384;358;642
"1835";"4. Rosenberger known";544;26;518;161;839
"1836";"5. Optimal adjusted";434;124;310;518;482
"1837";"1. Random";410;110;300;485;515
"1838";"6. Biased  coin";402;103;299;503;500
"1839";"2. Neyman known";426;109;317;458;542
"1840";"3. RSIHR Known";464;88;376;376;624
"1841";"4. Rosenberger known";535;30;505;149;851
"1842";"5. Optimal adjusted";392;106;286;526;474
"1843";"1. Random";405;93;312;482;518
"1844";"6. Biased  coin";396;97;299;500;500
"1845";"2. Neyman known";419;109;310;469;531
"1846";"3. RSIHR Known";446;75;371;379;621
"1847";"4. Rosenberger known";540;24;516;137;863
"1848";"5. Optimal adjusted";374;104;270;551;449
"1849";"1. Random";370;86;284;514;486
"1850";"6. Biased  coin";390;89;301;501;499
"1851";"2. Neyman known";396;74;322;449;551
"1852";"3. RSIHR Known";442;65;377;362;638
"1853";"4. Rosenberger known";538;26;512;139;861
"1854";"5. Optimal adjusted";360;93;267;532;468
"1855";"1. Random";413;98;315;484;516
"1856";"6. Biased  coin";381;88;293;502;499
"1857";"2. Neyman known";403;93;310;464;536
"1858";"3. RSIHR Known";461;61;400;350;650
"1859";"4. Rosenberger known";550;28;522;141;859
"1860";"5. Optimal adjusted";384;99;285;540;460
"1861";"1. Random";388;100;288;505;495
"1862";"6. Biased  coin";387;101;286;503;500
"1863";"2. Neyman known";406;81;325;437;563
"1864";"3. RSIHR Known";440;84;356;397;603
"1865";"4. Rosenberger known";549;31;518;127;873
"1866";"5. Optimal adjusted";367;112;255;567;433
"1867";"1. Random";406;107;299;502;498
"1868";"6. Biased  coin";428;116;312;500;500
"1869";"2. Neyman known";441;110;331;453;547
"1870";"3. RSIHR Known";486;80;406;342;658
"1871";"4. Rosenberger known";556;30;526;135;865
"1872";"5. Optimal adjusted";402;120;282;538;462
"1873";"1. Random";403;125;278;534;466
"1874";"6. Biased  coin";401;113;288;501;500
"1875";"2. Neyman known";388;86;302;441;559
"1876";"3. RSIHR Known";445;83;362;357;643
"1877";"4. Rosenberger known";513;33;480;159;841
"1878";"5. Optimal adjusted";394;116;278;526;474
"1879";"1. Random";391;108;283;523;477
"1880";"6. Biased  coin";403;101;302;502;498
"1881";"2. Neyman known";425;89;336;447;553
"1882";"3. RSIHR Known";460;88;372;376;624
"1883";"4. Rosenberger known";546;28;518;136;864
"1884";"5. Optimal adjusted";391;111;280;530;470
"1885";"1. Random";383;88;295;494;506
"1886";"6. Biased  coin";391;95;296;500;501
"1887";"2. Neyman known";414;96;318;463;537
"1888";"3. RSIHR Known";455;64;391;342;658
"1889";"4. Rosenberger known";524;38;486;139;861
"1890";"5. Optimal adjusted";393;111;282;527;473
"1891";"1. Random";397;92;305;490;510
"1892";"6. Biased  coin";390;93;297;500;500
"1893";"2. Neyman known";414;99;315;459;541
"1894";"3. RSIHR Known";431;65;366;375;625
"1895";"4. Rosenberger known";537;18;519;126;874
"1896";"5. Optimal adjusted";378;97;281;518;482
"1897";"1. Random";395;109;286;505;495
"1898";"6. Biased  coin";397;104;293;500;500
"1899";"2. Neyman known";404;86;318;436;564
"1900";"3. RSIHR Known";446;71;375;369;631
"1901";"4. Rosenberger known";535;37;498;151;849
"1902";"5. Optimal adjusted";374;112;262;553;447
"1903";"1. Random";409;110;299;518;482
"1904";"6. Biased  coin";387;96;291;499;502
"1905";"2. Neyman known";416;79;337;432;568
"1906";"3. RSIHR Known";462;70;392;351;649
"1907";"4. Rosenberger known";536;27;509;143;857
"1908";"5. Optimal adjusted";382;116;266;550;450
"1909";"1. Random";374;109;265;529;471
"1910";"6. Biased  coin";391;101;290;501;499
"1911";"2. Neyman known";411;78;333;430;570
"1912";"3. RSIHR Known";435;75;360;371;629
"1913";"4. Rosenberger known";521;32;489;144;856
"1914";"5. Optimal adjusted";370;103;267;531;469
"1915";"1. Random";394;109;285;499;501
"1916";"6. Biased  coin";410;116;294;502;499
"1917";"2. Neyman known";436;88;348;426;574
"1918";"3. RSIHR Known";476;79;397;347;653
"1919";"4. Rosenberger known";546;34;512;151;849
"1920";"5. Optimal adjusted";391;113;278;523;477
"1921";"1. Random";409;109;300;501;499
"1922";"6. Biased  coin";406;106;300;502;498
"1923";"2. Neyman known";417;82;335;433;567
"1924";"3. RSIHR Known";469;87;382;351;649
"1925";"4. Rosenberger known";542;24;518;128;872
"1926";"5. Optimal adjusted";375;111;264;548;452
"1927";"1. Random";434;113;321;484;516
"1928";"6. Biased  coin";421;109;312;504;500
"1929";"2. Neyman known";438;108;330;473;527
"1930";"3. RSIHR Known";489;97;392;369;631
"1931";"4. Rosenberger known";554;27;527;146;854
"1932";"5. Optimal adjusted";428;130;298;527;473
"1933";"1. Random";395;102;293;504;496
"1934";"6. Biased  coin";391;101;290;501;499
"1935";"2. Neyman known";413;81;332;430;570
"1936";"3. RSIHR Known";447;86;361;384;616
"1937";"4. Rosenberger known";537;30;507;132;868
"1938";"5. Optimal adjusted";389;108;281;519;481
"1939";"1. Random";417;121;296;508;492
"1940";"6. Biased  coin";414;113;301;499;501
"1941";"2. Neyman known";434;107;327;435;565
"1942";"3. RSIHR Known";452;87;365;378;622
"1943";"4. Rosenberger known";548;29;519;131;869
"1944";"5. Optimal adjusted";391;116;275;535;465
"1945";"1. Random";379;119;260;539;461
"1946";"6. Biased  coin";403;109;294;500;500
"1947";"2. Neyman known";434;96;338;428;572
"1948";"3. RSIHR Known";455;80;375;348;652
"1949";"4. Rosenberger known";539;33;506;141;859
"1950";"5. Optimal adjusted";410;120;290;513;487
"1951";"1. Random";408;118;290;524;476
"1952";"6. Biased  coin";416;108;308;502;500
"1953";"2. Neyman known";430;104;326;463;537
"1954";"3. RSIHR Known";477;96;381;385;615
"1955";"4. Rosenberger known";535;27;508;157;843
"1956";"5. Optimal adjusted";414;120;294;532;468
"1957";"1. Random";422;90;332;463;537
"1958";"6. Biased  coin";388;92;296;500;500
"1959";"2. Neyman known";418;84;334;449;551
"1960";"3. RSIHR Known";451;64;387;349;651
"1961";"4. Rosenberger known";544;27;517;143;857
"1962";"5. Optimal adjusted";371;108;263;558;442
"1963";"1. Random";385;96;289;499;501
"1964";"6. Biased  coin";413;115;298;501;500
"1965";"2. Neyman known";414;98;316;472;528
"1966";"3. RSIHR Known";459;79;380;366;634
"1967";"4. Rosenberger known";567;39;528;129;871
"1968";"5. Optimal adjusted";389;118;271;559;441
"1969";"1. Random";420;107;313;496;504
"1970";"6. Biased  coin";400;104;296;500;501
"1971";"2. Neyman known";406;74;332;431;569
"1972";"3. RSIHR Known";469;80;389;368;632
"1973";"4. Rosenberger known";553;38;515;141;859
"1974";"5. Optimal adjusted";366;110;256;536;464
"1975";"1. Random";393;98;295;494;506
"1976";"6. Biased  coin";393;94;299;501;499
"1977";"2. Neyman known";398;88;310;461;539
"1978";"3. RSIHR Known";446;73;373;351;649
"1979";"4. Rosenberger known";544;27;517;130;870
"1980";"5. Optimal adjusted";364;99;265;540;460
"1981";"1. Random";381;97;284;515;485
"1982";"6. Biased  coin";418;104;314;500;500
"1983";"2. Neyman known";403;99;304;458;542
"1984";"3. RSIHR Known";457;77;380;352;648
"1985";"4. Rosenberger known";531;30;501;159;841
"1986";"5. Optimal adjusted";392;115;277;531;469
"1987";"1. Random";400;108;292;501;499
"1988";"6. Biased  coin";395;107;288;500;500
"1989";"2. Neyman known";411;82;329;453;547
"1990";"3. RSIHR Known";467;68;399;329;671
"1991";"4. Rosenberger known";525;25;500;132;868
"1992";"5. Optimal adjusted";375;100;275;526;474
"1993";"1. Random";407;99;308;492;508
"1994";"6. Biased  coin";412;109;303;501;499
"1995";"2. Neyman known";409;81;328;442;558
"1996";"3. RSIHR Known";468;78;390;363;637
"1997";"4. Rosenberger known";550;21;529;119;881
"1998";"5. Optimal adjusted";403;119;284;534;466
"1999";"1. Random";402;105;297;491;509
"2000";"6. Biased  coin";408;112;296;500;501
"2001";"2. Neyman known";422;104;318;451;549
"2002";"3. RSIHR Known";420;65;355;378;622
"2003";"4. Rosenberger known";536;32;504;147;853
"2004";"5. Optimal adjusted";378;113;265;545;455
"2005";"1. Random";414;122;292;528;472
"2006";"6. Biased  coin";409;108;301;500;500
"2007";"2. Neyman known";419;95;324;459;541
"2008";"3. RSIHR Known";465;82;383;361;639
"2009";"4. Rosenberger known";561;31;530;132;868
"2010";"5. Optimal adjusted";398;110;288;527;473
"2011";"1. Random";422;101;321;480;520
"2012";"6. Biased  coin";390;99;291;500;500
"2013";"2. Neyman known";423;89;334;432;568
"2014";"3. RSIHR Known";460;87;373;360;640
"2015";"4. Rosenberger known";539;28;511;137;863
"2016";"5. Optimal adjusted";386;109;277;534;466
"2017";"1. Random";423;96;327;482;518
"2018";"6. Biased  coin";405;102;303;502;501
"2019";"2. Neyman known";450;105;345;432;568
"2020";"3. RSIHR Known";477;82;395;350;650
"2021";"4. Rosenberger known";548;27;521;127;873
"2022";"5. Optimal adjusted";401;128;273;550;450
"2023";"1. Random";396;111;285;483;517
"2024";"6. Biased  coin";386;106;280;500;500
"2025";"2. Neyman known";421;111;310;448;552
"2026";"3. RSIHR Known";435;75;360;366;634
"2027";"4. Rosenberger known";513;33;480;145;855
"2028";"5. Optimal adjusted";387;118;269;536;464
"2029";"1. Random";381;97;284;499;501
"2030";"6. Biased  coin";399;111;288;500;501
"2031";"2. Neyman known";392;87;305;460;540
"2032";"3. RSIHR Known";456;77;379;370;630
"2033";"4. Rosenberger known";538;34;504;135;865
"2034";"5. Optimal adjusted";389;110;279;518;482
"2035";"1. Random";406;114;292;532;468
"2036";"6. Biased  coin";389;91;298;501;500
"2037";"2. Neyman known";425;84;341;444;556
"2038";"3. RSIHR Known";460;78;382;357;643
"2039";"4. Rosenberger known";555;21;534;127;873
"2040";"5. Optimal adjusted";404;99;305;532;468
"2041";"1. Random";401;106;295;502;498
"2042";"6. Biased  coin";386;92;294;501;500
"2043";"2. Neyman known";423;85;338;439;561
"2044";"3. RSIHR Known";467;78;389;361;639
"2045";"4. Rosenberger known";545;20;525;125;875
"2046";"5. Optimal adjusted";383;116;267;558;442
"2047";"1. Random";401;100;301;494;506
"2048";"6. Biased  coin";390;98;292;499;501
"2049";"2. Neyman known";408;95;313;471;529
"2050";"3. RSIHR Known";450;74;376;362;638
"2051";"4. Rosenberger known";535;25;510;137;863
"2052";"5. Optimal adjusted";413;111;302;514;486
"2053";"1. Random";415;119;296;517;483
"2054";"6. Biased  coin";432;130;302;499;502
"2055";"2. Neyman known";418;93;325;434;566
"2056";"3. RSIHR Known";448;85;363;364;636
"2057";"4. Rosenberger known";521;27;494;135;865
"2058";"5. Optimal adjusted";406;129;277;522;478
"2059";"1. Random";405;105;300;501;499
"2060";"6. Biased  coin";389;96;293;502;498
"2061";"2. Neyman known";404;95;309;467;533
"2062";"3. RSIHR Known";421;68;353;387;613
"2063";"4. Rosenberger known";531;29;502;133;867
"2064";"5. Optimal adjusted";368;129;239;569;431
"2065";"1. Random";409;113;296;514;486
"2066";"6. Biased  coin";414;105;309;501;500
"2067";"2. Neyman known";427;86;341;438;562
"2068";"3. RSIHR Known";475;79;396;370;630
"2069";"4. Rosenberger known";552;32;520;151;849
"2070";"5. Optimal adjusted";397;124;273;563;437
"2071";"1. Random";397;108;289;488;512
"2072";"6. Biased  coin";393;100;293;500;500
"2073";"2. Neyman known";414;103;311;463;537
"2074";"3. RSIHR Known";429;64;365;358;642
"2075";"4. Rosenberger known";515;30;485;146;854
"2076";"5. Optimal adjusted";373;111;262;529;471
"2077";"1. Random";394;110;284;507;493
"2078";"6. Biased  coin";386;94;292;500;500
"2079";"2. Neyman known";399;82;317;449;551
"2080";"3. RSIHR Known";456;79;377;344;656
"2081";"4. Rosenberger known";529;24;505;124;876
"2082";"5. Optimal adjusted";362;101;261;529;471
"2083";"1. Random";418;108;310;502;498
"2084";"6. Biased  coin";385;95;290;500;500
"2085";"2. Neyman known";414;80;334;435;565
"2086";"3. RSIHR Known";441;62;379;355;645
"2087";"4. Rosenberger known";542;34;508;142;858
"2088";"5. Optimal adjusted";391;118;273;539;461
"2089";"1. Random";391;101;290;494;506
"2090";"6. Biased  coin";402;105;297;500;500
"2091";"2. Neyman known";415;103;312;457;543
"2092";"3. RSIHR Known";445;71;374;360;640
"2093";"4. Rosenberger known";525;27;498;133;867
"2094";"5. Optimal adjusted";391;115;276;540;460
"2095";"1. Random";403;99;304;496;504
"2096";"6. Biased  coin";403;103;300;508;495
"2097";"2. Neyman known";413;96;317;456;544
"2098";"3. RSIHR Known";453;77;376;377;623
"2099";"4. Rosenberger known";534;25;509;144;856
"2100";"5. Optimal adjusted";376;119;257;564;436
"2101";"1. Random";402;111;291;499;501
"2102";"6. Biased  coin";398;104;294;501;500
"2103";"2. Neyman known";420;89;331;421;579
"2104";"3. RSIHR Known";461;70;391;334;666
"2105";"4. Rosenberger known";536;22;514;127;873
"2106";"5. Optimal adjusted";400;113;287;517;483
"2107";"1. Random";396;91;305;487;513
"2108";"6. Biased  coin";375;93;282;500;500
"2109";"2. Neyman known";417;84;333;445;555
"2110";"3. RSIHR Known";450;86;364;391;609
"2111";"4. Rosenberger known";524;26;498;136;864
"2112";"5. Optimal adjusted";372;113;259;551;449
"2113";"1. Random";391;105;286;505;495
"2114";"6. Biased  coin";409;104;305;501;501
"2115";"2. Neyman known";426;88;338;435;565
"2116";"3. RSIHR Known";435;86;349;402;598
"2117";"4. Rosenberger known";531;33;498;157;843
"2118";"5. Optimal adjusted";407;109;298;523;477
"2119";"1. Random";397;95;302;481;519
"2120";"6. Biased  coin";395;89;306;503;499
"2121";"2. Neyman known";417;79;338;425;575
"2122";"3. RSIHR Known";453;72;381;368;632
"2123";"4. Rosenberger known";541;38;503;154;846
"2124";"5. Optimal adjusted";363;94;269;543;457
"2125";"1. Random";411;97;314;473;527
"2126";"6. Biased  coin";409;108;301;500;500
"2127";"2. Neyman known";423;102;321;459;541
"2128";"3. RSIHR Known";446;63;383;366;634
"2129";"4. Rosenberger known";559;40;519;139;861
"2130";"5. Optimal adjusted";403;122;281;546;454
"2131";"1. Random";412;98;314;473;527
"2132";"6. Biased  coin";409;114;295;501;500
"2133";"2. Neyman known";425;84;341;439;561
"2134";"3. RSIHR Known";459;78;381;374;626
"2135";"4. Rosenberger known";532;25;507;146;854
"2136";"5. Optimal adjusted";394;107;287;515;485
"2137";"1. Random";410;122;288;509;491
"2138";"6. Biased  coin";406;109;297;501;500
"2139";"2. Neyman known";416;100;316;450;550
"2140";"3. RSIHR Known";444;83;361;374;626
"2141";"4. Rosenberger known";525;32;493;128;872
"2142";"5. Optimal adjusted";400;127;273;534;466
"2143";"1. Random";400;94;306;491;509
"2144";"6. Biased  coin";383;90;293;500;500
"2145";"2. Neyman known";422;76;346;443;557
"2146";"3. RSIHR Known";456;73;383;375;625
"2147";"4. Rosenberger known";556;33;523;148;852
"2148";"5. Optimal adjusted";388;105;283;551;449
"2149";"1. Random";389;99;290;503;497
"2150";"6. Biased  coin";399;109;290;502;500
"2151";"2. Neyman known";405;92;313;446;554
"2152";"3. RSIHR Known";429;66;363;353;647
"2153";"4. Rosenberger known";528;26;502;135;865
"2154";"5. Optimal adjusted";404;110;294;523;477
"2155";"1. Random";416;105;311;480;520
"2156";"6. Biased  coin";414;112;302;500;500
"2157";"2. Neyman known";425;91;334;443;557
"2158";"3. RSIHR Known";434;77;357;390;610
"2159";"4. Rosenberger known";540;33;507;144;856
"2160";"5. Optimal adjusted";392;118;274;547;453
"2161";"1. Random";372;78;294;490;510
"2162";"6. Biased  coin";415;109;306;501;500
"2163";"2. Neyman known";415;110;305;484;516
"2164";"3. RSIHR Known";459;68;391;359;641
"2165";"4. Rosenberger known";536;38;498;167;833
"2166";"5. Optimal adjusted";419;117;302;512;488
"2167";"1. Random";386;95;291;502;498
"2168";"6. Biased  coin";404;104;300;500;500
"2169";"2. Neyman known";400;90;310;469;531
"2170";"3. RSIHR Known";437;68;369;373;627
"2171";"4. Rosenberger known";554;32;522;139;861
"2172";"5. Optimal adjusted";382;109;273;537;463
"2173";"1. Random";393;97;296;478;522
"2174";"6. Biased  coin";388;109;279;503;499
"2175";"2. Neyman known";397;94;303;456;544
"2176";"3. RSIHR Known";439;77;362;350;650
"2177";"4. Rosenberger known";501;26;475;148;852
"2178";"5. Optimal adjusted";406;126;280;525;475
"2179";"1. Random";417;108;309;487;513
"2180";"6. Biased  coin";409;105;304;499;501
"2181";"2. Neyman known";438;84;354;433;567
"2182";"3. RSIHR Known";452;77;375;378;622
"2183";"4. Rosenberger known";538;34;504;154;846
"2184";"5. Optimal adjusted";392;104;288;516;484
"2185";"1. Random";409;91;318;485;515
"2186";"6. Biased  coin";387;90;297;502;500
"2187";"2. Neyman known";417;81;336;445;555
"2188";"3. RSIHR Known";457;73;384;383;617
"2189";"4. Rosenberger known";550;24;526;147;853
"2190";"5. Optimal adjusted";366;95;271;549;451
"2191";"1. Random";403;117;286;527;473
"2192";"6. Biased  coin";400;102;298;500;500
"2193";"2. Neyman known";404;85;319;456;544
"2194";"3. RSIHR Known";463;73;390;345;655
"2195";"4. Rosenberger known";548;38;510;152;848
"2196";"5. Optimal adjusted";379;104;275;531;469
"2197";"1. Random";411;102;309;486;514
"2198";"6. Biased  coin";430;109;321;500;502
"2199";"2. Neyman known";460;99;361;431;569
"2200";"3. RSIHR Known";454;70;384;383;617
"2201";"4. Rosenberger known";569;24;545;149;851
"2202";"5. Optimal adjusted";410;127;283;572;428
"2203";"1. Random";405;92;313;498;502
"2204";"6. Biased  coin";404;100;304;501;500
"2205";"2. Neyman known";431;84;347;423;577
"2206";"3. RSIHR Known";466;75;391;358;642
"2207";"4. Rosenberger known";533;28;505;155;845
"2208";"5. Optimal adjusted";385;108;277;548;452
"2209";"1. Random";396;114;282;514;486
"2210";"6. Biased  coin";393;104;289;501;500
"2211";"2. Neyman known";393;91;302;462;538
"2212";"3. RSIHR Known";456;76;380;354;646
"2213";"4. Rosenberger known";513;27;486;154;846
"2214";"5. Optimal adjusted";383;102;281;537;463
"2215";"1. Random";384;98;286;498;502
"2216";"6. Biased  coin";391;107;284;501;499
"2217";"2. Neyman known";377;80;297;469;531
"2218";"3. RSIHR Known";438;57;381;351;649
"2219";"4. Rosenberger known";532;33;499;143;857
"2220";"5. Optimal adjusted";383;105;278;533;467
"2221";"1. Random";381;99;282;511;489
"2222";"6. Biased  coin";390;94;296;499;501
"2223";"2. Neyman known";390;70;320;435;565
"2224";"3. RSIHR Known";451;69;382;374;626
"2225";"4. Rosenberger known";520;21;499;148;852
"2226";"5. Optimal adjusted";359;88;271;524;476
"2227";"1. Random";413;111;302;489;511
"2228";"6. Biased  coin";397;125;272;498;502
"2229";"2. Neyman known";400;102;298;481;519
"2230";"3. RSIHR Known";429;74;355;357;643
"2231";"4. Rosenberger known";514;34;480;151;849
"2232";"5. Optimal adjusted";378;114;264;515;485
"2233";"1. Random";391;91;300;480;520
"2234";"6. Biased  coin";378;103;275;501;500
"2235";"2. Neyman known";419;100;319;449;551
"2236";"3. RSIHR Known";441;79;362;368;632
"2237";"4. Rosenberger known";542;23;519;125;875
"2238";"5. Optimal adjusted";394;114;280;544;456
"2239";"1. Random";388;109;279;532;468
"2240";"6. Biased  coin";407;99;308;500;500
"2241";"2. Neyman known";416;83;333;451;549
"2242";"3. RSIHR Known";468;67;401;345;655
"2243";"4. Rosenberger known";552;24;528;118;882
"2244";"5. Optimal adjusted";373;96;277;526;474
"2245";"1. Random";395;104;291;515;485
"2246";"6. Biased  coin";408;110;298;502;501
"2247";"2. Neyman known";416;98;318;454;546
"2248";"3. RSIHR Known";444;77;367;379;621
"2249";"4. Rosenberger known";544;44;500;146;854
"2250";"5. Optimal adjusted";402;123;279;523;477
"2251";"1. Random";412;98;314;490;510
"2252";"6. Biased  coin";399;95;304;501;500
"2253";"2. Neyman known";435;90;345;451;549
"2254";"3. RSIHR Known";436;83;353;403;597
"2255";"4. Rosenberger known";549;28;521;140;860
"2256";"5. Optimal adjusted";411;108;303;510;490
"2257";"1. Random";416;116;300;498;502
"2258";"6. Biased  coin";408;116;292;502;499
"2259";"2. Neyman known";433;100;333;438;562
"2260";"3. RSIHR Known";458;84;374;373;627
"2261";"4. Rosenberger known";522;31;491;145;855
"2262";"5. Optimal adjusted";398;120;278;525;475
"2263";"1. Random";393;96;297;513;487
"2264";"6. Biased  coin";412;96;316;500;500
"2265";"2. Neyman known";416;83;333;441;559
"2266";"3. RSIHR Known";448;72;376;362;638
"2267";"4. Rosenberger known";545;22;523;141;859
"2268";"5. Optimal adjusted";375;109;266;541;459
"2269";"1. Random";416;128;288;517;483
"2270";"6. Biased  coin";424;116;308;501;501
"2271";"2. Neyman known";451;115;336;452;548
"2272";"3. RSIHR Known";455;75;380;359;641
"2273";"4. Rosenberger known";545;41;504;152;848
"2274";"5. Optimal adjusted";423;118;305;509;491
"2275";"1. Random";409;101;308;500;500
"2276";"6. Biased  coin";420;111;309;501;499
"2277";"2. Neyman known";450;94;356;427;573
"2278";"3. RSIHR Known";455;60;395;371;629
"2279";"4. Rosenberger known";560;29;531;151;849
"2280";"5. Optimal adjusted";413;126;287;549;451
"2281";"1. Random";365;107;258;541;459
"2282";"6. Biased  coin";408;107;301;500;500
"2283";"2. Neyman known";412;95;317;445;555
"2284";"3. RSIHR Known";440;74;366;360;640
"2285";"4. Rosenberger known";537;40;497;150;850
"2286";"5. Optimal adjusted";394;129;265;548;452
"2287";"1. Random";430;106;324;477;523
"2288";"6. Biased  coin";397;91;306;500;501
"2289";"2. Neyman known";428;88;340;430;570
"2290";"3. RSIHR Known";444;71;373;366;634
"2291";"4. Rosenberger known";537;23;514;136;864
"2292";"5. Optimal adjusted";388;116;272;541;459
"2293";"1. Random";400;101;299;492;508
"2294";"6. Biased  coin";416;112;304;503;501
"2295";"2. Neyman known";406;95;311;471;529
"2296";"3. RSIHR Known";458;81;377;365;635
"2297";"4. Rosenberger known";544;26;518;142;858
"2298";"5. Optimal adjusted";377;105;272;543;457
"2299";"1. Random";380;77;303;479;521
"2300";"6. Biased  coin";379;99;280;501;499
"2301";"2. Neyman known";410;93;317;454;546
"2302";"3. RSIHR Known";433;54;379;339;661
"2303";"4. Rosenberger known";515;18;497;131;869
"2304";"5. Optimal adjusted";376;104;272;545;455
"2305";"1. Random";391;91;300;468;532
"2306";"6. Biased  coin";372;87;285;500;500
"2307";"2. Neyman known";411;94;317;445;555
"2308";"3. RSIHR Known";432;66;366;371;629
"2309";"4. Rosenberger known";511;29;482;152;848
"2310";"5. Optimal adjusted";368;103;265;528;472
"2311";"1. Random";383;95;288;508;492
"2312";"6. Biased  coin";390;91;299;501;499
"2313";"2. Neyman known";400;79;321;440;560
"2314";"3. RSIHR Known";438;69;369;354;646
"2315";"4. Rosenberger known";507;22;485;144;856
"2316";"5. Optimal adjusted";372;100;272;534;466
"2317";"1. Random";389;106;283;501;499
"2318";"6. Biased  coin";406;115;291;500;500
"2319";"2. Neyman known";431;110;321;451;549
"2320";"3. RSIHR Known";433;77;356;377;623
"2321";"4. Rosenberger known";521;25;496;137;863
"2322";"5. Optimal adjusted";401;120;281;521;479
"2323";"1. Random";419;107;312;495;505
"2324";"6. Biased  coin";402;107;295;501;499
"2325";"2. Neyman known";418;106;312;483;517
"2326";"3. RSIHR Known";453;71;382;371;629
"2327";"4. Rosenberger known";532;29;503;139;861
"2328";"5. Optimal adjusted";373;106;267;539;461
"2329";"1. Random";393;103;290;516;484
"2330";"6. Biased  coin";395;109;286;502;499
"2331";"2. Neyman known";413;98;315;449;551
"2332";"3. RSIHR Known";430;63;367;376;624
"2333";"4. Rosenberger known";531;28;503;147;853
"2334";"5. Optimal adjusted";383;110;273;542;458
"2335";"1. Random";373;105;268;520;480
"2336";"6. Biased  coin";394;96;298;499;502
"2337";"2. Neyman known";400;87;313;445;555
"2338";"3. RSIHR Known";418;70;348;375;625
"2339";"4. Rosenberger known";516;21;495;131;869
"2340";"5. Optimal adjusted";374;110;264;535;465
"2341";"1. Random";388;100;288;488;512
"2342";"6. Biased  coin";410;111;299;501;500
"2343";"2. Neyman known";447;116;331;447;553
"2344";"3. RSIHR Known";451;79;372;370;630
"2345";"4. Rosenberger known";529;24;505;122;878
"2346";"5. Optimal adjusted";410;118;292;505;495
"2347";"1. Random";402;104;298;509;491
"2348";"6. Biased  coin";415;100;315;500;500
"2349";"2. Neyman known";433;99;334;456;544
"2350";"3. RSIHR Known";474;82;392;375;625
"2351";"4. Rosenberger known";555;26;529;127;873
"2352";"5. Optimal adjusted";401;112;289;525;475
"2353";"1. Random";421;111;310;491;509
"2354";"6. Biased  coin";386;97;289;499;501
"2355";"2. Neyman known";444;106;338;452;548
"2356";"3. RSIHR Known";465;71;394;337;663
"2357";"4. Rosenberger known";563;33;530;124;876
"2358";"5. Optimal adjusted";376;117;259;542;458
"2359";"1. Random";421;105;316;478;522
"2360";"6. Biased  coin";425;115;310;503;498
"2361";"2. Neyman known";426;98;328;463;537
"2362";"3. RSIHR Known";456;66;390;343;657
"2363";"4. Rosenberger known";543;27;516;145;855
"2364";"5. Optimal adjusted";383;115;268;525;475
"2365";"1. Random";417;96;321;478;522
"2366";"6. Biased  coin";404;106;298;499;501
"2367";"2. Neyman known";420;75;345;438;562
"2368";"3. RSIHR Known";429;67;362;371;629
"2369";"4. Rosenberger known";507;19;488;136;864
"2370";"5. Optimal adjusted";387;112;275;523;477
"2371";"1. Random";389;104;285;500;500
"2372";"6. Biased  coin";365;97;268;502;499
"2373";"2. Neyman known";416;85;331;430;570
"2374";"3. RSIHR Known";421;70;351;384;616
"2375";"4. Rosenberger known";512;28;484;146;854
"2376";"5. Optimal adjusted";379;117;262;555;445
"2377";"1. Random";374;111;263;508;492
"2378";"6. Biased  coin";392;107;285;500;500
"2379";"2. Neyman known";419;103;316;445;555
"2380";"3. RSIHR Known";452;78;374;361;639
"2381";"4. Rosenberger known";519;35;484;145;855
"2382";"5. Optimal adjusted";397;107;290;505;495
"2383";"1. Random";388;93;295;487;513
"2384";"6. Biased  coin";395;106;289;500;500
"2385";"2. Neyman known";388;94;294;469;531
"2386";"3. RSIHR Known";423;61;362;363;637
"2387";"4. Rosenberger known";515;28;487;142;858
"2388";"5. Optimal adjusted";371;101;270;525;475
"2389";"1. Random";401;95;306;499;501
"2390";"6. Biased  coin";394;94;300;501;500
"2391";"2. Neyman known";405;78;327;443;557
"2392";"3. RSIHR Known";466;60;406;339;661
"2393";"4. Rosenberger known";535;24;511;146;854
"2394";"5. Optimal adjusted";362;105;257;556;444
"2395";"1. Random";371;94;277;520;480
"2396";"6. Biased  coin";383;99;284;502;500
"2397";"2. Neyman known";390;85;305;463;537
"2398";"3. RSIHR Known";437;75;362;362;638
"2399";"4. Rosenberger known";530;30;500;141;859
"2400";"5. Optimal adjusted";373;96;277;525;475
"2401";"1. Random";416;113;303;502;498
"2402";"6. Biased  coin";438;110;328;501;500
"2403";"2. Neyman known";428;99;329;470;530
"2404";"3. RSIHR Known";475;87;388;376;624
"2405";"4. Rosenberger known";563;45;518;170;830
"2406";"5. Optimal adjusted";414;118;296;532;468
"2407";"1. Random";375;86;289;500;500
"2408";"6. Biased  coin";385;88;297;500;501
"2409";"2. Neyman known";421;79;342;445;555
"2410";"3. RSIHR Known";435;71;364;393;607
"2411";"4. Rosenberger known";543;28;515;135;865
"2412";"5. Optimal adjusted";398;92;306;496;504
"2413";"1. Random";404;103;301;522;478
"2414";"6. Biased  coin";401;106;295;499;501
"2415";"2. Neyman known";446;93;353;423;577
"2416";"3. RSIHR Known";440;84;356;405;595
"2417";"4. Rosenberger known";532;31;501;155;845
"2418";"5. Optimal adjusted";381;117;264;565;435
"2419";"1. Random";403;103;300;511;489
"2420";"6. Biased  coin";392;107;285;504;500
"2421";"2. Neyman known";435;104;331;448;552
"2422";"3. RSIHR Known";457;67;390;357;643
"2423";"4. Rosenberger known";527;28;499;154;846
"2424";"5. Optimal adjusted";379;111;268;540;460
"2425";"1. Random";400;98;302;485;515
"2426";"6. Biased  coin";406;104;302;500;500
"2427";"2. Neyman known";390;88;302;477;523
"2428";"3. RSIHR Known";460;87;373;365;635
"2429";"4. Rosenberger known";538;21;517;120;880
"2430";"5. Optimal adjusted";381;104;277;516;484
"2431";"1. Random";419;106;313;478;522
"2432";"6. Biased  coin";390;89;301;501;499
"2433";"2. Neyman known";416;83;333;453;547
"2434";"3. RSIHR Known";450;69;381;360;640
"2435";"4. Rosenberger known";545;31;514;139;861
"2436";"5. Optimal adjusted";392;113;279;536;464
"2437";"1. Random";417;104;313;503;497
"2438";"6. Biased  coin";411;109;302;502;499
"2439";"2. Neyman known";435;92;343;437;563
"2440";"3. RSIHR Known";474;74;400;355;645
"2441";"4. Rosenberger known";549;28;521;135;865
"2442";"5. Optimal adjusted";373;114;259;551;449
"2443";"1. Random";391;99;292;498;502
"2444";"6. Biased  coin";391;99;292;502;501
"2445";"2. Neyman known";423;89;334;450;550
"2446";"3. RSIHR Known";476;80;396;357;643
"2447";"4. Rosenberger known";540;31;509;151;849
"2448";"5. Optimal adjusted";399;122;277;544;456
"2449";"1. Random";377;91;286;503;497
"2450";"6. Biased  coin";390;96;294;502;500
"2451";"2. Neyman known";396;89;307;470;530
"2452";"3. RSIHR Known";447;83;364;373;627
"2453";"4. Rosenberger known";536;25;511;133;867
"2454";"5. Optimal adjusted";385;101;284;523;477
"2455";"1. Random";425;116;309;500;500
"2456";"6. Biased  coin";418;101;317;502;499
"2457";"2. Neyman known";423;96;327;461;539
"2458";"3. RSIHR Known";483;84;399;372;628
"2459";"4. Rosenberger known";569;27;542;138;862
"2460";"5. Optimal adjusted";404;106;298;510;490
"2461";"1. Random";410;118;292;511;489
"2462";"6. Biased  coin";411;110;301;500;500
"2463";"2. Neyman known";424;86;338;413;587
"2464";"3. RSIHR Known";467;96;371;393;607
"2465";"4. Rosenberger known";528;26;502;153;847
"2466";"5. Optimal adjusted";400;118;282;543;457
"2467";"1. Random";404;101;303;517;483
"2468";"6. Biased  coin";401;99;302;500;500
"2469";"2. Neyman known";411;95;316;476;524
"2470";"3. RSIHR Known";463;66;397;355;645
"2471";"4. Rosenberger known";544;28;516;142;858
"2472";"5. Optimal adjusted";386;119;267;552;448
"2473";"1. Random";382;83;299;502;498
"2474";"6. Biased  coin";401;99;302;500;501
"2475";"2. Neyman known";397;78;319;453;547
"2476";"3. RSIHR Known";438;65;373;373;627
"2477";"4. Rosenberger known";547;28;519;150;850
"2478";"5. Optimal adjusted";384;95;289;514;486
"2479";"1. Random";417;104;313;490;510
"2480";"6. Biased  coin";425;119;306;500;500
"2481";"2. Neyman known";457;101;356;421;579
"2482";"3. RSIHR Known";457;88;369;388;612
"2483";"4. Rosenberger known";557;39;518;150;850
"2484";"5. Optimal adjusted";402;115;287;550;450
"2485";"1. Random";384;93;291;474;526
"2486";"6. Biased  coin";398;109;289;500;500
"2487";"2. Neyman known";408;95;313;466;534
"2488";"3. RSIHR Known";456;80;376;357;643
"2489";"4. Rosenberger known";511;29;482;154;846
"2490";"5. Optimal adjusted";379;120;259;542;458
"2491";"1. Random";388;97;291;515;485
"2492";"6. Biased  coin";398;97;301;500;500
"2493";"2. Neyman known";416;78;338;436;564
"2494";"3. RSIHR Known";451;69;382;383;617
"2495";"4. Rosenberger known";552;22;530;138;862
"2496";"5. Optimal adjusted";401;117;284;551;449
"2497";"1. Random";386;93;293;510;490
"2498";"6. Biased  coin";390;99;291;501;499
"2499";"2. Neyman known";411;75;336;445;555
"2500";"3. RSIHR Known";436;71;365;356;644
"2501";"4. Rosenberger known";529;34;495;162;838
"2502";"5. Optimal adjusted";380;101;279;536;464
"2503";"1. Random";403;107;296;488;512
"2504";"6. Biased  coin";375;82;293;500;500
"2505";"2. Neyman known";417;79;338;435;565
"2506";"3. RSIHR Known";451;67;384;376;624
"2507";"4. Rosenberger known";538;27;511;155;845
"2508";"5. Optimal adjusted";393;99;294;517;483
"2509";"1. Random";370;89;281;509;491
"2510";"6. Biased  coin";356;67;289;500;500
"2511";"2. Neyman known";394;73;321;451;549
"2512";"3. RSIHR Known";438;61;377;364;636
"2513";"4. Rosenberger known";523;27;496;135;865
"2514";"5. Optimal adjusted";333;85;248;567;433
"2515";"1. Random";390;83;307;496;504
"2516";"6. Biased  coin";388;89;299;499;502
"2517";"2. Neyman known";425;83;342;452;548
"2518";"3. RSIHR Known";453;63;390;349;651
"2519";"4. Rosenberger known";550;29;521;151;849
"2520";"5. Optimal adjusted";372;107;265;565;435
"2521";"1. Random";425;114;311;478;522
"2522";"6. Biased  coin";395;105;290;501;499
"2523";"2. Neyman known";440;95;345;437;563
"2524";"3. RSIHR Known";466;77;389;341;659
"2525";"4. Rosenberger known";523;25;498;145;855
"2526";"5. Optimal adjusted";418;128;290;533;467
"2527";"1. Random";407;104;303;495;505
"2528";"6. Biased  coin";408;121;287;502;500
"2529";"2. Neyman known";412;92;320;445;555
"2530";"3. RSIHR Known";449;82;367;379;621
"2531";"4. Rosenberger known";533;33;500;151;849
"2532";"5. Optimal adjusted";389;120;269;544;456
"2533";"1. Random";393;106;287;510;490
"2534";"6. Biased  coin";404;95;309;501;499
"2535";"2. Neyman known";403;84;319;438;562
"2536";"3. RSIHR Known";464;76;388;337;663
"2537";"4. Rosenberger known";560;33;527;148;852
"2538";"5. Optimal adjusted";395;110;285;541;459
"2539";"1. Random";379;94;285;493;507
"2540";"6. Biased  coin";401;115;286;500;500
"2541";"2. Neyman known";426;97;329;433;567
"2542";"3. RSIHR Known";440;72;368;369;631
"2543";"4. Rosenberger known";537;31;506;136;864
"2544";"5. Optimal adjusted";385;115;270;529;471
"2545";"1. Random";396;97;299;486;514
"2546";"6. Biased  coin";378;99;279;502;500
"2547";"2. Neyman known";427;89;338;431;569
"2548";"3. RSIHR Known";455;76;379;362;638
"2549";"4. Rosenberger known";525;20;505;137;863
"2550";"5. Optimal adjusted";370;104;266;531;469
"2551";"1. Random";381;85;296;480;520
"2552";"6. Biased  coin";379;87;292;502;500
"2553";"2. Neyman known";405;87;318;446;554
"2554";"3. RSIHR Known";418;50;368;369;631
"2555";"4. Rosenberger known";526;25;501;136;864
"2556";"5. Optimal adjusted";370;99;271;531;469
"2557";"1. Random";420;111;309;489;511
"2558";"6. Biased  coin";409;98;311;500;501
"2559";"2. Neyman known";448;95;353;435;565
"2560";"3. RSIHR Known";452;71;381;380;620
"2561";"4. Rosenberger known";553;29;524;140;860
"2562";"5. Optimal adjusted";360;82;278;526;474
"2563";"1. Random";402;111;291;493;507
"2564";"6. Biased  coin";404;102;302;502;500
"2565";"2. Neyman known";422;99;323;452;548
"2566";"3. RSIHR Known";463;73;390;343;657
"2567";"4. Rosenberger known";537;36;501;151;849
"2568";"5. Optimal adjusted";382;116;266;528;472
"2569";"1. Random";407;98;309;480;520
"2570";"6. Biased  coin";388;96;292;499;501
"2571";"2. Neyman known";428;84;344;442;558
"2572";"3. RSIHR Known";458;85;373;374;626
"2573";"4. Rosenberger known";547;25;522;131;869
"2574";"5. Optimal adjusted";383;118;265;555;445
"2575";"1. Random";394;106;288;522;478
"2576";"6. Biased  coin";395;107;288;501;499
"2577";"2. Neyman known";405;96;309;455;545
"2578";"3. RSIHR Known";447;76;371;358;642
"2579";"4. Rosenberger known";518;36;482;166;834
"2580";"5. Optimal adjusted";386;113;273;548;452
"2581";"1. Random";378;88;290;509;491
"2582";"6. Biased  coin";385;99;286;501;500
"2583";"2. Neyman known";423;84;339;445;555
"2584";"3. RSIHR Known";448;72;376;370;630
"2585";"4. Rosenberger known";558;25;533;122;878
"2586";"5. Optimal adjusted";379;86;293;509;491
"2587";"1. Random";381;96;285;506;494
"2588";"6. Biased  coin";422;105;317;503;501
"2589";"2. Neyman known";403;93;310;468;532
"2590";"3. RSIHR Known";464;84;380;385;615
"2591";"4. Rosenberger known";552;33;519;148;852
"2592";"5. Optimal adjusted";403;107;296;517;483
"2593";"1. Random";389;98;291;507;493
"2594";"6. Biased  coin";410;104;306;500;500
"2595";"2. Neyman known";430;97;333;442;558
"2596";"3. RSIHR Known";469;81;388;368;632
"2597";"4. Rosenberger known";567;30;537;125;875
"2598";"5. Optimal adjusted";394;102;292;528;472
"2599";"1. Random";406;107;299;490;510
"2600";"6. Biased  coin";396;95;301;500;500
"2601";"2. Neyman known";437;79;358;420;580
"2602";"3. RSIHR Known";462;76;386;356;644
"2603";"4. Rosenberger known";537;30;507;151;849
"2604";"5. Optimal adjusted";401;115;286;513;487
"2605";"1. Random";417;109;308;505;495
"2606";"6. Biased  coin";372;91;281;501;500
"2607";"2. Neyman known";387;71;316;452;548
"2608";"3. RSIHR Known";440;70;370;369;631
"2609";"4. Rosenberger known";533;29;504;135;865
"2610";"5. Optimal adjusted";379;100;279;533;467
"2611";"1. Random";410;104;306;488;512
"2612";"6. Biased  coin";390;113;277;500;500
"2613";"2. Neyman known";409;88;321;452;548
"2614";"3. RSIHR Known";461;83;378;365;635
"2615";"4. Rosenberger known";537;26;511;138;862
"2616";"5. Optimal adjusted";400;130;270;556;444
"2617";"1. Random";409;84;325;460;540
"2618";"6. Biased  coin";392;94;298;498;502
"2619";"2. Neyman known";416;78;338;431;569
"2620";"3. RSIHR Known";462;74;388;358;642
"2621";"4. Rosenberger known";532;33;499;162;838
"2622";"5. Optimal adjusted";410;114;296;527;473
"2623";"1. Random";393;108;285;506;494
"2624";"6. Biased  coin";413;113;300;502;500
"2625";"2. Neyman known";418;92;326;438;562
"2626";"3. RSIHR Known";444;62;382;344;656
"2627";"4. Rosenberger known";532;39;493;161;839
"2628";"5. Optimal adjusted";386;117;269;518;482
"2629";"1. Random";409;95;314;472;528
"2630";"6. Biased  coin";392;102;290;503;499
"2631";"2. Neyman known";409;77;332;440;560
"2632";"3. RSIHR Known";464;75;389;356;644
"2633";"4. Rosenberger known";548;23;525;132;868
"2634";"5. Optimal adjusted";394;100;294;521;479
"2635";"1. Random";404;106;298;489;511
"2636";"6. Biased  coin";404;103;301;501;500
"2637";"2. Neyman known";413;88;325;444;556
"2638";"3. RSIHR Known";447;77;370;370;630
"2639";"4. Rosenberger known";536;22;514;128;872
"2640";"5. Optimal adjusted";388;97;291;506;494
"2641";"1. Random";401;100;301;494;506
"2642";"6. Biased  coin";399;101;298;502;500
"2643";"2. Neyman known";428;90;338;443;557
"2644";"3. RSIHR Known";467;70;397;351;649
"2645";"4. Rosenberger known";546;33;513;143;857
"2646";"5. Optimal adjusted";372;116;256;579;421
"2647";"1. Random";403;107;296;512;488
"2648";"6. Biased  coin";390;96;294;499;501
"2649";"2. Neyman known";434;99;335;451;549
"2650";"3. RSIHR Known";455;79;376;372;628
"2651";"4. Rosenberger known";529;31;498;159;841
"2652";"5. Optimal adjusted";388;108;280;524;476
"2653";"1. Random";366;88;278;495;505
"2654";"6. Biased  coin";378;82;296;500;500
"2655";"2. Neyman known";390;86;304;448;552
"2656";"3. RSIHR Known";423;61;362;351;649
"2657";"4. Rosenberger known";501;26;475;151;849
"2658";"5. Optimal adjusted";357;90;267;520;480
"2659";"1. Random";427;122;305;512;488
"2660";"6. Biased  coin";409;100;309;501;500
"2661";"2. Neyman known";436;97;339;459;541
"2662";"3. RSIHR Known";467;82;385;362;638
"2663";"4. Rosenberger known";556;26;530;133;867
"2664";"5. Optimal adjusted";386;121;265;560;440
"2665";"1. Random";389;94;295;502;498
"2666";"6. Biased  coin";413;115;298;502;500
"2667";"2. Neyman known";426;93;333;441;559
"2668";"3. RSIHR Known";459;73;386;337;663
"2669";"4. Rosenberger known";534;33;501;152;848
"2670";"5. Optimal adjusted";384;107;277;544;456
"2671";"1. Random";404;110;294;496;504
"2672";"6. Biased  coin";389;99;290;500;500
"2673";"2. Neyman known";450;109;341;444;556
"2674";"3. RSIHR Known";451;74;377;377;623
"2675";"4. Rosenberger known";536;27;509;134;866
"2676";"5. Optimal adjusted";388;131;257;570;430
"2677";"1. Random";379;97;282;508;492
"2678";"6. Biased  coin";369;104;265;501;502
"2679";"2. Neyman known";415;94;321;435;565
"2680";"3. RSIHR Known";447;83;364;374;626
"2681";"4. Rosenberger known";504;31;473;162;838
"2682";"5. Optimal adjusted";366;119;247;539;461
"2683";"1. Random";402;113;289;503;497
"2684";"6. Biased  coin";420;117;303;500;500
"2685";"2. Neyman known";430;95;335;452;548
"2686";"3. RSIHR Known";472;86;386;368;632
"2687";"4. Rosenberger known";554;34;520;153;847
"2688";"5. Optimal adjusted";381;121;260;556;444
"2689";"1. Random";409;118;291;515;485
"2690";"6. Biased  coin";392;106;286;500;500
"2691";"2. Neyman known";407;80;327;439;561
"2692";"3. RSIHR Known";447;83;364;382;618
"2693";"4. Rosenberger known";537;34;503;141;859
"2694";"5. Optimal adjusted";385;118;267;534;466
"2695";"1. Random";399;101;298;518;482
"2696";"6. Biased  coin";424;110;314;501;499
"2697";"2. Neyman known";445;88;357;437;563
"2698";"3. RSIHR Known";474;75;399;367;633
"2699";"4. Rosenberger known";556;25;531;133;867
"2700";"5. Optimal adjusted";396;111;285;527;473
"2701";"1. Random";399;100;299;479;521
"2702";"6. Biased  coin";377;96;281;503;500
"2703";"2. Neyman known";420;94;326;441;559
"2704";"3. RSIHR Known";421;69;352;389;611
"2705";"4. Rosenberger known";534;33;501;147;853
"2706";"5. Optimal adjusted";374;96;278;520;480
"2707";"1. Random";423;114;309;488;512
"2708";"6. Biased  coin";417;102;315;501;500
"2709";"2. Neyman known";405;84;321;456;544
"2710";"3. RSIHR Known";444;73;371;382;618
"2711";"4. Rosenberger known";543;27;516;147;853
"2712";"5. Optimal adjusted";386;104;282;518;482
"2713";"1. Random";412;89;323;481;519
"2714";"6. Biased  coin";393;91;302;499;501
"2715";"2. Neyman known";409;75;334;441;559
"2716";"3. RSIHR Known";439;75;364;354;646
"2717";"4. Rosenberger known";524;21;503;127;873
"2718";"5. Optimal adjusted";378;108;270;527;473
"2719";"1. Random";414;116;298;530;470
"2720";"6. Biased  coin";404;106;298;499;501
"2721";"2. Neyman known";419;95;324;431;569
"2722";"3. RSIHR Known";477;80;397;340;660
"2723";"4. Rosenberger known";550;35;515;147;853
"2724";"5. Optimal adjusted";398;109;289;518;482
"2725";"1. Random";387;111;276;518;482
"2726";"6. Biased  coin";432;123;309;502;500
"2727";"2. Neyman known";408;89;319;448;552
"2728";"3. RSIHR Known";476;93;383;362;638
"2729";"4. Rosenberger known";521;37;484;171;829
"2730";"5. Optimal adjusted";403;121;282;516;484
"2731";"1. Random";392;95;297;496;504
"2732";"6. Biased  coin";393;97;296;501;499
"2733";"2. Neyman known";418;94;324;467;533
"2734";"3. RSIHR Known";447;71;376;380;620
"2735";"4. Rosenberger known";543;31;512;152;848
"2736";"5. Optimal adjusted";389;105;284;528;472
"2737";"1. Random";416;118;298;495;505
"2738";"6. Biased  coin";398;111;287;500;500
"2739";"2. Neyman known";402;107;295;473;527
"2740";"3. RSIHR Known";441;78;363;379;621
"2741";"4. Rosenberger known";524;27;497;133;867
"2742";"5. Optimal adjusted";383;116;267;539;461
"2743";"1. Random";385;98;287;502;498
"2744";"6. Biased  coin";388;97;291;500;500
"2745";"2. Neyman known";433;111;322;454;546
"2746";"3. RSIHR Known";458;82;376;373;627
"2747";"4. Rosenberger known";532;30;502;146;854
"2748";"5. Optimal adjusted";376;109;267;549;451
"2749";"1. Random";394;92;302;486;514
"2750";"6. Biased  coin";407;102;305;500;500
"2751";"2. Neyman known";435;83;352;441;559
"2752";"3. RSIHR Known";431;68;363;372;628
"2753";"4. Rosenberger known";541;24;517;145;855
"2754";"5. Optimal adjusted";376;115;261;564;436
"2755";"1. Random";422;92;330;461;539
"2756";"6. Biased  coin";394;96;298;502;500
"2757";"2. Neyman known";417;91;326;452;548
"2758";"3. RSIHR Known";448;78;370;383;617
"2759";"4. Rosenberger known";555;32;523;138;862
"2760";"5. Optimal adjusted";369;99;270;519;481
"2761";"1. Random";406;86;320;490;510
"2762";"6. Biased  coin";397;99;298;501;500
"2763";"2. Neyman known";412;84;328;451;549
"2764";"3. RSIHR Known";463;68;395;338;662
"2765";"4. Rosenberger known";542;27;515;149;851
"2766";"5. Optimal adjusted";395;104;291;533;467
"2767";"1. Random";413;107;306;508;492
"2768";"6. Biased  coin";407;100;307;498;503
"2769";"2. Neyman known";437;94;343;424;576
"2770";"3. RSIHR Known";459;77;382;378;622
"2771";"4. Rosenberger known";549;39;510;159;841
"2772";"5. Optimal adjusted";395;109;286;529;471
"2773";"1. Random";404;95;309;482;518
"2774";"6. Biased  coin";422;103;319;499;501
"2775";"2. Neyman known";432;90;342;444;556
"2776";"3. RSIHR Known";452;59;393;331;669
"2777";"4. Rosenberger known";542;28;514;150;850
"2778";"5. Optimal adjusted";364;94;270;543;457
"2779";"1. Random";382;99;283;532;468
"2780";"6. Biased  coin";388;88;300;500;501
"2781";"2. Neyman known";439;98;341;445;555
"2782";"3. RSIHR Known";451;68;383;370;630
"2783";"4. Rosenberger known";553;31;522;142;858
"2784";"5. Optimal adjusted";407;120;287;538;462
"2785";"1. Random";386;99;287;497;503
"2786";"6. Biased  coin";387;104;283;500;500
"2787";"2. Neyman known";420;91;329;435;565
"2788";"3. RSIHR Known";441;73;368;359;641
"2789";"4. Rosenberger known";523;25;498;136;864
"2790";"5. Optimal adjusted";386;118;268;540;460
"2791";"1. Random";426;125;301;494;506
"2792";"6. Biased  coin";418;115;303;499;501
"2793";"2. Neyman known";435;97;338;432;568
"2794";"3. RSIHR Known";468;89;379;379;621
"2795";"4. Rosenberger known";534;17;517;130;870
"2796";"5. Optimal adjusted";397;112;285;523;477
"2797";"1. Random";388;98;290;490;510
"2798";"6. Biased  coin";385;87;298;502;499
"2799";"2. Neyman known";406;97;309;474;526
"2800";"3. RSIHR Known";427;61;366;369;631
"2801";"4. Rosenberger known";533;30;503;152;848
"2802";"5. Optimal adjusted";384;80;304;495;505
"2803";"1. Random";380;92;288;504;496
"2804";"6. Biased  coin";371;83;288;501;501
"2805";"2. Neyman known";433;89;344;430;570
"2806";"3. RSIHR Known";451;77;374;372;628
"2807";"4. Rosenberger known";542;26;516;139;861
"2808";"5. Optimal adjusted";396;110;286;529;471
"2809";"1. Random";386;92;294;497;503
"2810";"6. Biased  coin";378;95;283;499;501
"2811";"2. Neyman known";407;87;320;436;564
"2812";"3. RSIHR Known";419;71;348;375;625
"2813";"4. Rosenberger known";516;23;493;126;874
"2814";"5. Optimal adjusted";372;108;264;514;486
"2815";"1. Random";343;94;249;532;468
"2816";"6. Biased  coin";357;82;275;501;500
"2817";"2. Neyman known";399;89;310;433;567
"2818";"3. RSIHR Known";420;64;356;362;638
"2819";"4. Rosenberger known";494;23;471;143;857
"2820";"5. Optimal adjusted";371;111;260;557;443
"2821";"1. Random";395;105;290;501;499
"2822";"6. Biased  coin";389;97;292;500;500
"2823";"2. Neyman known";391;80;311;451;549
"2824";"3. RSIHR Known";437;74;363;370;630
"2825";"4. Rosenberger known";531;23;508;139;861
"2826";"5. Optimal adjusted";382;100;282;520;480
"2827";"1. Random";420;105;315;499;501
"2828";"6. Biased  coin";396;103;293;501;500
"2829";"2. Neyman known";423;92;331;461;539
"2830";"3. RSIHR Known";444;65;379;374;626
"2831";"4. Rosenberger known";540;22;518;145;855
"2832";"5. Optimal adjusted";384;106;278;529;471
"2833";"1. Random";398;87;311;482;518
"2834";"6. Biased  coin";400;99;301;497;503
"2835";"2. Neyman known";427;86;341;453;547
"2836";"3. RSIHR Known";452;62;390;362;638
"2837";"4. Rosenberger known";543;27;516;147;853
"2838";"5. Optimal adjusted";382;107;275;549;451
"2839";"1. Random";400;83;317;475;525
"2840";"6. Biased  coin";414;105;309;503;498
"2841";"2. Neyman known";427;90;337;440;560
"2842";"3. RSIHR Known";439;71;368;368;632
"2843";"4. Rosenberger known";538;33;505;150;850
"2844";"5. Optimal adjusted";386;108;278;536;464
"2845";"1. Random";402;97;305;506;494
"2846";"6. Biased  coin";391;103;288;500;500
"2847";"2. Neyman known";407;92;315;457;543
"2848";"3. RSIHR Known";443;66;377;375;625
"2849";"4. Rosenberger known";533;28;505;128;872
"2850";"5. Optimal adjusted";358;96;262;551;449
"2851";"1. Random";383;78;305;488;512
"2852";"6. Biased  coin";406;106;300;501;500
"2853";"2. Neyman known";382;83;299;464;536
"2854";"3. RSIHR Known";440;77;363;386;614
"2855";"4. Rosenberger known";542;35;507;150;850
"2856";"5. Optimal adjusted";367;109;258;528;472
"2857";"1. Random";405;102;303;491;509
"2858";"6. Biased  coin";397;100;297;501;500
"2859";"2. Neyman known";413;75;338;434;566
"2860";"3. RSIHR Known";451;70;381;356;644
"2861";"4. Rosenberger known";548;24;524;133;867
"2862";"5. Optimal adjusted";399;99;300;512;488
"2863";"1. Random";411;104;307;501;499
"2864";"6. Biased  coin";411;110;301;499;501
"2865";"2. Neyman known";416;101;315;462;538
"2866";"3. RSIHR Known";451;84;367;371;629
"2867";"4. Rosenberger known";547;27;520;136;864
"2868";"5. Optimal adjusted";401;112;289;536;464
"2869";"1. Random";408;103;305;481;519
"2870";"6. Biased  coin";389;100;289;499;501
"2871";"2. Neyman known";425;106;319;467;533
"2872";"3. RSIHR Known";461;86;375;359;641
"2873";"4. Rosenberger known";551;38;513;144;856
"2874";"5. Optimal adjusted";400;119;281;550;450
"2875";"1. Random";399;114;285;534;466
"2876";"6. Biased  coin";392;106;286;501;500
"2877";"2. Neyman known";414;101;313;446;554
"2878";"3. RSIHR Known";423;67;356;380;620
"2879";"4. Rosenberger known";528;32;496;148;852
"2880";"5. Optimal adjusted";385;110;275;533;467
"2881";"1. Random";421;82;339;459;541
"2882";"6. Biased  coin";409;94;315;501;499
"2883";"2. Neyman known";429;84;345;439;561
"2884";"3. RSIHR Known";461;68;393;370;630
"2885";"4. Rosenberger known";558;35;523;162;838
"2886";"5. Optimal adjusted";371;80;291;519;481
"2887";"1. Random";392;105;287;513;487
"2888";"6. Biased  coin";392;91;301;501;500
"2889";"2. Neyman known";417;106;311;485;515
"2890";"3. RSIHR Known";455;59;396;346;654
"2891";"4. Rosenberger known";535;22;513;134;866
"2892";"5. Optimal adjusted";389;102;287;524;476
"2893";"1. Random";420;106;314;499;501
"2894";"6. Biased  coin";388;95;293;503;501
"2895";"2. Neyman known";440;88;352;448;552
"2896";"3. RSIHR Known";460;65;395;352;648
"2897";"4. Rosenberger known";544;32;512;147;853
"2898";"5. Optimal adjusted";382;106;276;536;464
"2899";"1. Random";420;99;321;461;539
"2900";"6. Biased  coin";409;119;290;499;501
"2901";"2. Neyman known";416;85;331;425;575
"2902";"3. RSIHR Known";446;85;361;365;635
"2903";"4. Rosenberger known";527;41;486;162;838
"2904";"5. Optimal adjusted";366;113;253;551;449
"2905";"1. Random";396;98;298;503;497
"2906";"6. Biased  coin";423;96;327;500;500
"2907";"2. Neyman known";422;76;346;435;565
"2908";"3. RSIHR Known";467;80;387;380;620
"2909";"4. Rosenberger known";547;28;519;163;837
"2910";"5. Optimal adjusted";397;102;295;521;479
"2911";"1. Random";410;111;299;489;511
"2912";"6. Biased  coin";423;123;300;501;500
"2913";"2. Neyman known";438;101;337;454;546
"2914";"3. RSIHR Known";475;99;376;372;628
"2915";"4. Rosenberger known";548;22;526;125;875
"2916";"5. Optimal adjusted";412;134;278;546;454
"2917";"1. Random";405;116;289;510;490
"2918";"6. Biased  coin";388;100;288;501;502
"2919";"2. Neyman known";419;91;328;443;557
"2920";"3. RSIHR Known";485;77;408;340;660
"2921";"4. Rosenberger known";530;30;500;160;840
"2922";"5. Optimal adjusted";398;128;270;567;433
"2923";"1. Random";394;94;300;484;516
"2924";"6. Biased  coin";400;101;299;502;500
"2925";"2. Neyman known";397;74;323;439;561
"2926";"3. RSIHR Known";443;57;386;344;656
"2927";"4. Rosenberger known";536;32;504;147;853
"2928";"5. Optimal adjusted";367;95;272;529;471
"2929";"1. Random";404;101;303;480;520
"2930";"6. Biased  coin";412;116;296;501;500
"2931";"2. Neyman known";432;91;341;446;554
"2932";"3. RSIHR Known";481;70;411;333;667
"2933";"4. Rosenberger known";549;31;518;140;860
"2934";"5. Optimal adjusted";382;112;270;556;444
"2935";"1. Random";398;100;298;489;511
"2936";"6. Biased  coin";398;104;294;499;503
"2937";"2. Neyman known";431;93;338;451;549
"2938";"3. RSIHR Known";461;98;363;371;629
"2939";"4. Rosenberger known";543;32;511;145;855
"2940";"5. Optimal adjusted";404;122;282;530;470
"2941";"1. Random";365;99;266;521;479
"2942";"6. Biased  coin";410;105;305;501;499
"2943";"2. Neyman known";410;84;326;452;548
"2944";"3. RSIHR Known";455;77;378;353;647
"2945";"4. Rosenberger known";532;30;502;148;852
"2946";"5. Optimal adjusted";363;103;260;574;426
"2947";"1. Random";395;101;294;492;508
"2948";"6. Biased  coin";421;115;306;501;500
"2949";"2. Neyman known";428;99;329;455;545
"2950";"3. RSIHR Known";451;67;384;356;644
"2951";"4. Rosenberger known";562;34;528;141;859
"2952";"5. Optimal adjusted";399;112;287;502;498
"2953";"1. Random";373;95;278;499;501
"2954";"6. Biased  coin";397;98;299;500;500
"2955";"2. Neyman known";395;75;320;448;552
"2956";"3. RSIHR Known";434;75;359;384;616
"2957";"4. Rosenberger known";533;30;503;146;854
"2958";"5. Optimal adjusted";372;112;260;556;444
"2959";"1. Random";413;84;329;479;521
"2960";"6. Biased  coin";385;97;288;501;499
"2961";"2. Neyman known";407;82;325;473;527
"2962";"3. RSIHR Known";466;68;398;356;644
"2963";"4. Rosenberger known";555;23;532;131;869
"2964";"5. Optimal adjusted";402;112;290;553;447
"2965";"1. Random";413;91;322;493;507
"2966";"6. Biased  coin";381;85;296;504;498
"2967";"2. Neyman known";419;86;333;442;558
"2968";"3. RSIHR Known";443;65;378;374;626
"2969";"4. Rosenberger known";545;22;523;135;865
"2970";"5. Optimal adjusted";385;112;273;543;457
"2971";"1. Random";369;86;283;523;477
"2972";"6. Biased  coin";391;92;299;502;501
"2973";"2. Neyman known";404;83;321;454;546
"2974";"3. RSIHR Known";434;71;363;381;619
"2975";"4. Rosenberger known";531;27;504;144;856
"2976";"5. Optimal adjusted";367;100;267;545;455
"2977";"1. Random";381;113;268;526;474
"2978";"6. Biased  coin";383;103;280;498;502
"2979";"2. Neyman known";414;110;304;465;535
"2980";"3. RSIHR Known";436;80;356;376;624
"2981";"4. Rosenberger known";523;29;494;138;862
"2982";"5. Optimal adjusted";400;119;281;532;468
"2983";"1. Random";405;101;304;479;521
"2984";"6. Biased  coin";389;107;282;503;500
"2985";"2. Neyman known";431;92;339;421;579
"2986";"3. RSIHR Known";436;74;362;380;620
"2987";"4. Rosenberger known";528;28;500;141;859
"2988";"5. Optimal adjusted";384;109;275;532;468
"2989";"1. Random";393;96;297;485;515
"2990";"6. Biased  coin";370;89;281;500;500
"2991";"2. Neyman known";405;84;321;458;542
"2992";"3. RSIHR Known";458;81;377;358;642
"2993";"4. Rosenberger known";544;26;518;135;865
"2994";"5. Optimal adjusted";364;103;261;546;454
"2995";"1. Random";382;83;299;501;499
"2996";"6. Biased  coin";396;81;315;502;500
"2997";"2. Neyman known";401;87;314;457;543
"2998";"3. RSIHR Known";446;69;377;375;625
"2999";"4. Rosenberger known";531;27;504;150;850
"3000";"5. Optimal adjusted";358;98;260;552;448
"3001";"1. Random";396;105;291;517;483
"3002";"6. Biased  coin";403;111;292;501;500
"3003";"2. Neyman known";413;84;329;425;575
"3004";"3. RSIHR Known";450;77;373;378;622
"3005";"4. Rosenberger known";541;32;509;154;846
"3006";"5. Optimal adjusted";391;115;276;533;467
"3007";"1. Random";404;93;311;478;522
"3008";"6. Biased  coin";402;95;307;498;502
"3009";"2. Neyman known";417;91;326;455;545
"3010";"3. RSIHR Known";437;72;365;378;622
"3011";"4. Rosenberger known";548;38;510;153;847
"3012";"5. Optimal adjusted";377;103;274;544;456
"3013";"1. Random";398;92;306;485;515
"3014";"6. Biased  coin";401;94;307;499;502
"3015";"2. Neyman known";426;91;335;466;534
"3016";"3. RSIHR Known";448;60;388;346;654
"3017";"4. Rosenberger known";557;26;531;148;852
"3018";"5. Optimal adjusted";389;109;280;538;462
"3019";"1. Random";389;96;293;491;509
"3020";"6. Biased  coin";404;94;310;500;500
"3021";"2. Neyman known";427;83;344;439;561
"3022";"3. RSIHR Known";466;70;396;357;643
"3023";"4. Rosenberger known";552;28;524;135;865
"3024";"5. Optimal adjusted";390;91;299;489;511
"3025";"1. Random";349;87;262;502;498
"3026";"6. Biased  coin";378;95;283;501;500
"3027";"2. Neyman known";406;81;325;426;574
"3028";"3. RSIHR Known";422;68;354;367;633
"3029";"4. Rosenberger known";498;27;471;145;855
"3030";"5. Optimal adjusted";359;106;253;551;449
"3031";"1. Random";411;108;303;495;505
"3032";"6. Biased  coin";409;103;306;500;500
"3033";"2. Neyman known";426;101;325;461;539
"3034";"3. RSIHR Known";485;78;407;330;670
"3035";"4. Rosenberger known";553;25;528;141;859
"3036";"5. Optimal adjusted";405;127;278;535;465
"3037";"1. Random";397;110;287;519;481
"3038";"6. Biased  coin";411;93;318;503;500
"3039";"2. Neyman known";431;81;350;427;573
"3040";"3. RSIHR Known";462;75;387;366;634
"3041";"4. Rosenberger known";569;36;533;140;860
"3042";"5. Optimal adjusted";394;117;277;555;445
"3043";"1. Random";402;95;307;510;490
"3044";"6. Biased  coin";406;106;300;502;499
"3045";"2. Neyman known";420;76;344;444;556
"3046";"3. RSIHR Known";468;61;407;335;665
"3047";"4. Rosenberger known";544;34;510;145;855
"3048";"5. Optimal adjusted";397;100;297;520;480
"3049";"1. Random";373;107;266;502;498
"3050";"6. Biased  coin";389;98;291;500;501
"3051";"2. Neyman known";437;89;348;414;586
"3052";"3. RSIHR Known";447;75;372;353;647
"3053";"4. Rosenberger known";537;33;504;138;862
"3054";"5. Optimal adjusted";370;114;256;536;464
"3055";"1. Random";417;100;317;484;516
"3056";"6. Biased  coin";421;104;317;501;499
"3057";"2. Neyman known";401;88;313;473;527
"3058";"3. RSIHR Known";458;73;385;352;648
"3059";"4. Rosenberger known";525;24;501;142;858
"3060";"5. Optimal adjusted";385;104;281;534;466
"3061";"1. Random";416;120;296;514;486
"3062";"6. Biased  coin";401;111;290;501;500
"3063";"2. Neyman known";440;112;328;449;551
"3064";"3. RSIHR Known";455;77;378;368;632
"3065";"4. Rosenberger known";535;28;507;133;867
"3066";"5. Optimal adjusted";397;120;277;535;465
"3067";"1. Random";368;96;272;511;489
"3068";"6. Biased  coin";391;101;290;500;500
"3069";"2. Neyman known";425;98;327;457;543
"3070";"3. RSIHR Known";447;72;375;372;628
"3071";"4. Rosenberger known";553;31;522;132;868
"3072";"5. Optimal adjusted";385;109;276;537;463
"3073";"1. Random";367;90;277;516;484
"3074";"6. Biased  coin";416;109;307;500;500
"3075";"2. Neyman known";426;84;342;438;562
"3076";"3. RSIHR Known";453;81;372;355;645
"3077";"4. Rosenberger known";536;25;511;140;860
"3078";"5. Optimal adjusted";391;107;284;522;478
"3079";"1. Random";400;105;295;504;496
"3080";"6. Biased  coin";412;112;300;500;501
"3081";"2. Neyman known";433;97;336;424;576
"3082";"3. RSIHR Known";431;70;361;366;634
"3083";"4. Rosenberger known";536;29;507;128;872
"3084";"5. Optimal adjusted";365;99;266;556;444
"3085";"1. Random";378;98;280;511;489
"3086";"6. Biased  coin";366;84;282;501;499
"3087";"2. Neyman known";417;95;322;436;564
"3088";"3. RSIHR Known";393;54;339;367;633
"3089";"4. Rosenberger known";506;21;485;141;859
"3090";"5. Optimal adjusted";359;90;269;524;476
"3091";"1. Random";398;84;314;493;507
"3092";"6. Biased  coin";408;97;311;500;500
"3093";"2. Neyman known";410;86;324;468;532
"3094";"3. RSIHR Known";467;64;403;322;678
"3095";"4. Rosenberger known";553;30;523;150;850
"3096";"5. Optimal adjusted";391;101;290;543;457
"3097";"1. Random";390;82;308;480;520
"3098";"6. Biased  coin";400;100;300;501;499
"3099";"2. Neyman known";399;74;325;452;548
"3100";"3. RSIHR Known";427;61;366;377;623
"3101";"4. Rosenberger known";525;32;493;150;850
"3102";"5. Optimal adjusted";354;94;260;538;462
"3103";"1. Random";414;112;302;513;487
"3104";"6. Biased  coin";416;108;308;500;500
"3105";"2. Neyman known";455;100;355;437;563
"3106";"3. RSIHR Known";486;79;407;372;628
"3107";"4. Rosenberger known";570;28;542;129;871
"3108";"5. Optimal adjusted";419;117;302;518;482
"3109";"1. Random";379;89;290;493;507
"3110";"6. Biased  coin";387;102;285;499;501
"3111";"2. Neyman known";430;92;338;439;561
"3112";"3. RSIHR Known";428;72;356;379;621
"3113";"4. Rosenberger known";542;30;512;139;861
"3114";"5. Optimal adjusted";388;106;282;536;464
"3115";"1. Random";408;119;289;515;485
"3116";"6. Biased  coin";416;113;303;501;500
"3117";"2. Neyman known";402;99;303;447;553
"3118";"3. RSIHR Known";460;89;371;380;620
"3119";"4. Rosenberger known";531;39;492;153;847
"3120";"5. Optimal adjusted";362;107;255;560;440
"3121";"1. Random";396;101;295;520;480
"3122";"6. Biased  coin";422;107;315;501;500
"3123";"2. Neyman known";448;89;359;436;564
"3124";"3. RSIHR Known";477;68;409;355;645
"3125";"4. Rosenberger known";561;29;532;148;852
"3126";"5. Optimal adjusted";395;104;291;521;479
"3127";"1. Random";381;81;300;505;495
"3128";"6. Biased  coin";378;86;292;499;501
"3129";"2. Neyman known";409;80;329;439;561
"3130";"3. RSIHR Known";447;65;382;347;653
"3131";"4. Rosenberger known";529;19;510;136;864
"3132";"5. Optimal adjusted";373;86;287;521;479
"3133";"1. Random";417;91;326;462;538
"3134";"6. Biased  coin";411;98;313;499;501
"3135";"2. Neyman known";411;97;314;483;517
"3136";"3. RSIHR Known";449;80;369;379;621
"3137";"4. Rosenberger known";537;24;513;136;864
"3138";"5. Optimal adjusted";385;108;277;543;457
"3139";"1. Random";409;104;305;494;506
"3140";"6. Biased  coin";373;101;272;501;501
"3141";"2. Neyman known";402;84;318;439;561
"3142";"3. RSIHR Known";438;75;363;368;632
"3143";"4. Rosenberger known";531;36;495;145;855
"3144";"5. Optimal adjusted";391;111;280;519;481
"3145";"1. Random";398;93;305;491;509
"3146";"6. Biased  coin";386;96;290;500;500
"3147";"2. Neyman known";428;96;332;466;534
"3148";"3. RSIHR Known";444;69;375;377;623
"3149";"4. Rosenberger known";555;22;533;141;859
"3150";"5. Optimal adjusted";370;104;266;544;456
"3151";"1. Random";393;95;298;489;511
"3152";"6. Biased  coin";397;99;298;502;499
"3153";"2. Neyman known";430;102;328;445;555
"3154";"3. RSIHR Known";460;71;389;348;652
"3155";"4. Rosenberger known";544;28;516;138;862
"3156";"5. Optimal adjusted";383;116;267;569;431
"3157";"1. Random";430;104;326;479;521
"3158";"6. Biased  coin";421;107;314;501;499
"3159";"2. Neyman known";435;88;347;442;558
"3160";"3. RSIHR Known";461;60;401;350;650
"3161";"4. Rosenberger known";566;22;544;133;867
"3162";"5. Optimal adjusted";391;102;289;549;451
"3163";"1. Random";415;103;312;472;528
"3164";"6. Biased  coin";390;101;289;500;500
"3165";"2. Neyman known";418;90;328;444;556
"3166";"3. RSIHR Known";433;71;362;371;629
"3167";"4. Rosenberger known";525;29;496;155;845
"3168";"5. Optimal adjusted";367;109;258;542;458
"3169";"1. Random";365;91;274;511;489
"3170";"6. Biased  coin";387;96;291;502;499
"3171";"2. Neyman known";393;84;309;458;542
"3172";"3. RSIHR Known";404;62;342;407;593
"3173";"4. Rosenberger known";528;36;492;174;826
"3174";"5. Optimal adjusted";377;96;281;518;482
"3175";"1. Random";400;96;304;484;516
"3176";"6. Biased  coin";377;107;270;501;499
"3177";"2. Neyman known";421;100;321;460;540
"3178";"3. RSIHR Known";435;77;358;396;604
"3179";"4. Rosenberger known";529;36;493;155;845
"3180";"5. Optimal adjusted";390;112;278;525;475
"3181";"1. Random";379;112;267;524;476
"3182";"6. Biased  coin";392;92;300;499;501
"3183";"2. Neyman known";423;84;339;412;588
"3184";"3. RSIHR Known";449;77;372;347;653
"3185";"4. Rosenberger known";518;29;489;146;854
"3186";"5. Optimal adjusted";369;109;260;540;460
"3187";"1. Random";404;100;304;482;518
"3188";"6. Biased  coin";371;103;268;501;499
"3189";"2. Neyman known";413;98;315;465;535
"3190";"3. RSIHR Known";438;72;366;372;628
"3191";"4. Rosenberger known";533;28;505;149;851
"3192";"5. Optimal adjusted";398;111;287;512;488
"3193";"1. Random";387;105;282;502;498
"3194";"6. Biased  coin";366;93;273;499;501
"3195";"2. Neyman known";402;88;314;428;572
"3196";"3. RSIHR Known";438;81;357;359;641
"3197";"4. Rosenberger known";522;29;493;133;867
"3198";"5. Optimal adjusted";387;121;266;523;477
"3199";"1. Random";408;112;296;513;487
"3200";"6. Biased  coin";415;108;307;498;502
"3201";"2. Neyman known";451;95;356;429;571
"3202";"3. RSIHR Known";471;83;388;381;619
"3203";"4. Rosenberger known";556;28;528;129;871
"3204";"5. Optimal adjusted";388;95;293;510;490
"3205";"1. Random";408;92;316;509;491
"3206";"6. Biased  coin";410;101;309;501;500
"3207";"2. Neyman known";423;89;334;463;537
"3208";"3. RSIHR Known";447;77;370;396;604
"3209";"4. Rosenberger known";551;29;522;141;859
"3210";"5. Optimal adjusted";388;109;279;536;464
"3211";"1. Random";434;116;318;492;508
"3212";"6. Biased  coin";427;124;303;501;500
"3213";"2. Neyman known";424;91;333;442;558
"3214";"3. RSIHR Known";455;77;378;367;633
"3215";"4. Rosenberger known";546;31;515;146;854
"3216";"5. Optimal adjusted";401;120;281;533;467
"3217";"1. Random";391;86;305;488;512
"3218";"6. Biased  coin";404;101;303;501;500
"3219";"2. Neyman known";433;94;339;435;565
"3220";"3. RSIHR Known";434;69;365;386;614
"3221";"4. Rosenberger known";546;31;515;153;847
"3222";"5. Optimal adjusted";367;97;270;525;475
"3223";"1. Random";387;103;284;504;496
"3224";"6. Biased  coin";396;113;283;502;499
"3225";"2. Neyman known";425;95;330;439;561
"3226";"3. RSIHR Known";428;78;350;388;612
"3227";"4. Rosenberger known";529;28;501;143;857
"3228";"5. Optimal adjusted";391;117;274;529;471
"3229";"1. Random";433;101;332;469;531
"3230";"6. Biased  coin";398;99;299;500;500
"3231";"2. Neyman known";423;98;325;459;541
"3232";"3. RSIHR Known";462;83;379;361;639
"3233";"4. Rosenberger known";523;29;494;160;840
"3234";"5. Optimal adjusted";399;117;282;513;487
"3235";"1. Random";366;99;267;513;487
"3236";"6. Biased  coin";384;104;280;502;498
"3237";"2. Neyman known";390;90;300;459;541
"3238";"3. RSIHR Known";435;69;366;353;647
"3239";"4. Rosenberger known";509;29;480;145;855
"3240";"5. Optimal adjusted";359;102;257;535;465
"3241";"1. Random";381;91;290;495;505
"3242";"6. Biased  coin";415;97;318;501;500
"3243";"2. Neyman known";396;76;320;461;539
"3244";"3. RSIHR Known";471;74;397;357;643
"3245";"4. Rosenberger known";535;25;510;145;855
"3246";"5. Optimal adjusted";409;104;305;535;465
"3247";"1. Random";394;87;307;476;524
"3248";"6. Biased  coin";373;96;277;501;499
"3249";"2. Neyman known";415;81;334;440;560
"3250";"3. RSIHR Known";424;64;360;372;628
"3251";"4. Rosenberger known";516;25;491;151;849
"3252";"5. Optimal adjusted";356;101;255;537;463
"3253";"1. Random";388;94;294;488;512
"3254";"6. Biased  coin";380;90;290;500;500
"3255";"2. Neyman known";424;93;331;459;541
"3256";"3. RSIHR Known";459;71;388;341;659
"3257";"4. Rosenberger known";517;31;486;157;843
"3258";"5. Optimal adjusted";380;103;277;557;443
"3259";"1. Random";386;102;284;502;498
"3260";"6. Biased  coin";400;111;289;497;503
"3261";"2. Neyman known";408;91;317;443;557
"3262";"3. RSIHR Known";422;73;349;363;637
"3263";"4. Rosenberger known";515;34;481;160;840
"3264";"5. Optimal adjusted";398;114;284;530;470
"3265";"1. Random";395;110;285;499;501
"3266";"6. Biased  coin";412;120;292;503;499
"3267";"2. Neyman known";438;114;324;450;550
"3268";"3. RSIHR Known";429;75;354;360;640
"3269";"4. Rosenberger known";519;31;488;140;860
"3270";"5. Optimal adjusted";406;127;279;516;484
"3271";"1. Random";402;104;298;514;486
"3272";"6. Biased  coin";407;101;306;499;501
"3273";"2. Neyman known";416;89;327;436;564
"3274";"3. RSIHR Known";442;94;348;398;602
"3275";"4. Rosenberger known";531;30;501;162;838
"3276";"5. Optimal adjusted";393;118;275;518;482
"3277";"1. Random";393;109;284;527;473
"3278";"6. Biased  coin";405;107;298;500;500
"3279";"2. Neyman known";437;95;342;453;547
"3280";"3. RSIHR Known";457;73;384;377;623
"3281";"4. Rosenberger known";553;33;520;147;853
"3282";"5. Optimal adjusted";396;107;289;537;463
"3283";"1. Random";398;93;305;458;542
"3284";"6. Biased  coin";394;94;300;501;500
"3285";"2. Neyman known";388;87;301;456;544
"3286";"3. RSIHR Known";448;75;373;366;634
"3287";"4. Rosenberger known";529;27;502;142;858
"3288";"5. Optimal adjusted";372;97;275;522;478
"3289";"1. Random";394;89;305;488;512
"3290";"6. Biased  coin";398;106;292;501;499
"3291";"2. Neyman known";449;93;356;436;564
"3292";"3. RSIHR Known";455;76;379;374;626
"3293";"4. Rosenberger known";552;27;525;128;872
"3294";"5. Optimal adjusted";393;100;293;530;470
"3295";"1. Random";425;109;316;493;507
"3296";"6. Biased  coin";409;92;317;502;498
"3297";"2. Neyman known";412;92;320;460;540
"3298";"3. RSIHR Known";468;63;405;353;647
"3299";"4. Rosenberger known";549;33;516;153;847
"3300";"5. Optimal adjusted";408;115;293;547;453
"3301";"1. Random";402;89;313;499;501
"3302";"6. Biased  coin";414;106;308;501;500
"3303";"2. Neyman known";419;85;334;450;550
"3304";"3. RSIHR Known";451;57;394;348;652
"3305";"4. Rosenberger known";540;22;518;151;849
"3306";"5. Optimal adjusted";395;107;288;527;473
"3307";"1. Random";399;112;287;493;507
"3308";"6. Biased  coin";398;113;285;500;500
"3309";"2. Neyman known";415;103;312;470;530
"3310";"3. RSIHR Known";450;83;367;373;627
"3311";"4. Rosenberger known";527;29;498;147;853
"3312";"5. Optimal adjusted";387;109;278;504;496
"3313";"1. Random";378;110;268;531;469
"3314";"6. Biased  coin";395;100;295;500;500
"3315";"2. Neyman known";409;86;323;445;555
"3316";"3. RSIHR Known";445;84;361;386;614
"3317";"4. Rosenberger known";522;38;484;157;843
"3318";"5. Optimal adjusted";388;114;274;532;468
"3319";"1. Random";377;93;284;496;504
"3320";"6. Biased  coin";403;111;292;502;499
"3321";"2. Neyman known";414;99;315;461;539
"3322";"3. RSIHR Known";435;83;352;385;615
"3323";"4. Rosenberger known";522;30;492;142;858
"3324";"5. Optimal adjusted";363;116;247;543;457
"3325";"1. Random";395;97;298;492;508
"3326";"6. Biased  coin";408;94;314;500;500
"3327";"2. Neyman known";403;84;319;472;528
"3328";"3. RSIHR Known";448;61;387;359;641
"3329";"4. Rosenberger known";544;22;522;131;869
"3330";"5. Optimal adjusted";380;98;282;530;470
"3331";"1. Random";407;101;306;517;483
"3332";"6. Biased  coin";410;103;307;503;498
"3333";"2. Neyman known";427;93;334;467;533
"3334";"3. RSIHR Known";461;66;395;356;644
"3335";"4. Rosenberger known";554;28;526;144;856
"3336";"5. Optimal adjusted";376;108;268;554;446
"3337";"1. Random";403;101;302;502;498
"3338";"6. Biased  coin";386;93;293;501;500
"3339";"2. Neyman known";424;82;342;427;573
"3340";"3. RSIHR Known";454;71;383;340;660
"3341";"4. Rosenberger known";531;27;504;143;857
"3342";"5. Optimal adjusted";362;117;245;574;426
"3343";"1. Random";380;89;291;494;506
"3344";"6. Biased  coin";400;94;306;498;502
"3345";"2. Neyman known";392;74;318;451;549
"3346";"3. RSIHR Known";455;76;379;356;644
"3347";"4. Rosenberger known";517;23;494;156;844
"3348";"5. Optimal adjusted";355;96;259;531;469
"3349";"1. Random";392;98;294;501;499
"3350";"6. Biased  coin";386;96;290;502;500
"3351";"2. Neyman known";411;93;318;463;537
"3352";"3. RSIHR Known";458;71;387;349;651
"3353";"4. Rosenberger known";558;27;531;135;865
"3354";"5. Optimal adjusted";384;101;283;530;470
"3355";"1. Random";408;98;310;493;507
"3356";"6. Biased  coin";380;93;287;501;500
"3357";"2. Neyman known";414;91;323;470;530
"3358";"3. RSIHR Known";439;70;369;377;623
"3359";"4. Rosenberger known";539;31;508;146;854
"3360";"5. Optimal adjusted";365;104;261;547;453
"3361";"1. Random";355;79;276;482;518
"3362";"6. Biased  coin";391;91;300;500;500
"3363";"2. Neyman known";380;79;301;458;542
"3364";"3. RSIHR Known";419;55;364;373;627
"3365";"4. Rosenberger known";506;22;484;141;859
"3366";"5. Optimal adjusted";334;96;238;561;439
"3367";"1. Random";400;99;301;490;510
"3368";"6. Biased  coin";405;107;298;501;500
"3369";"2. Neyman known";405;83;322;465;535
"3370";"3. RSIHR Known";475;78;397;362;638
"3371";"4. Rosenberger known";543;27;516;140;860
"3372";"5. Optimal adjusted";401;110;291;507;493
"3373";"1. Random";377;105;272;518;482
"3374";"6. Biased  coin";396;101;295;499;501
"3375";"2. Neyman known";409;88;321;453;547
"3376";"3. RSIHR Known";430;79;351;383;617
"3377";"4. Rosenberger known";517;26;491;155;845
"3378";"5. Optimal adjusted";365;98;267;533;467
"3379";"1. Random";423;116;307;507;493
"3380";"6. Biased  coin";402;104;298;496;504
"3381";"2. Neyman known";420;100;320;450;550
"3382";"3. RSIHR Known";449;86;363;366;634
"3383";"4. Rosenberger known";527;30;497;140;860
"3384";"5. Optimal adjusted";380;123;257;529;471
"3385";"1. Random";383;114;269;507;493
"3386";"6. Biased  coin";379;100;279;499;501
"3387";"2. Neyman known";400;97;303;445;555
"3388";"3. RSIHR Known";445;72;373;350;650
"3389";"4. Rosenberger known";508;40;468;174;826
"3390";"5. Optimal adjusted";377;111;266;540;460
"3391";"1. Random";387;101;286;509;491
"3392";"6. Biased  coin";382;104;278;502;500
"3393";"2. Neyman known";397;80;317;445;555
"3394";"3. RSIHR Known";439;75;364;386;614
"3395";"4. Rosenberger known";538;27;511;128;872
"3396";"5. Optimal adjusted";386;110;276;538;462
"3397";"1. Random";420;109;311;482;518
"3398";"6. Biased  coin";409;110;299;502;500
"3399";"2. Neyman known";429;103;326;450;550
"3400";"3. RSIHR Known";465;81;384;374;626
"3401";"4. Rosenberger known";539;34;505;160;840
"3402";"5. Optimal adjusted";399;120;279;530;470
"3403";"1. Random";413;99;314;510;490
"3404";"6. Biased  coin";385;84;301;500;500
"3405";"2. Neyman known";405;90;315;471;529
"3406";"3. RSIHR Known";466;64;402;361;639
"3407";"4. Rosenberger known";542;32;510;146;854
"3408";"5. Optimal adjusted";371;98;273;540;460
"3409";"1. Random";429;116;313;493;507
"3410";"6. Biased  coin";442;117;325;502;500
"3411";"2. Neyman known";438;96;342;459;541
"3412";"3. RSIHR Known";465;79;386;362;638
"3413";"4. Rosenberger known";561;34;527;149;851
"3414";"5. Optimal adjusted";407;129;278;543;457
"3415";"1. Random";408;94;314;481;519
"3416";"6. Biased  coin";396;99;297;500;502
"3417";"2. Neyman known";424;90;334;445;555
"3418";"3. RSIHR Known";474;73;401;356;644
"3419";"4. Rosenberger known";550;30;520;142;858
"3420";"5. Optimal adjusted";385;94;291;522;478
"3421";"1. Random";388;95;293;502;498
"3422";"6. Biased  coin";401;106;295;499;501
"3423";"2. Neyman known";411;96;315;478;522
"3424";"3. RSIHR Known";452;68;384;359;641
"3425";"4. Rosenberger known";550;28;522;130;870
"3426";"5. Optimal adjusted";387;105;282;511;489
"3427";"1. Random";388;102;286;517;483
"3428";"6. Biased  coin";393;101;292;500;501
"3429";"2. Neyman known";413;96;317;458;542
"3430";"3. RSIHR Known";446;66;380;356;644
"3431";"4. Rosenberger known";531;31;500;134;866
"3432";"5. Optimal adjusted";382;106;276;524;476
"3433";"1. Random";411;100;311;496;504
"3434";"6. Biased  coin";392;102;290;500;500
"3435";"2. Neyman known";416;93;323;459;541
"3436";"3. RSIHR Known";437;70;367;365;635
"3437";"4. Rosenberger known";537;31;506;145;855
"3438";"5. Optimal adjusted";351;92;259;540;460
"3439";"1. Random";397;89;308;481;519
"3440";"6. Biased  coin";388;95;293;500;500
"3441";"2. Neyman known";438;90;348;429;571
"3442";"3. RSIHR Known";437;69;368;363;637
"3443";"4. Rosenberger known";523;22;501;141;859
"3444";"5. Optimal adjusted";377;99;278;536;464
"3445";"1. Random";420;96;324;493;507
"3446";"6. Biased  coin";419;106;313;500;500
"3447";"2. Neyman known";437;82;355;431;569
"3448";"3. RSIHR Known";480;80;400;352;648
"3449";"4. Rosenberger known";562;23;539;138;862
"3450";"5. Optimal adjusted";384;100;284;548;452
"3451";"1. Random";420;109;311;488;512
"3452";"6. Biased  coin";392;100;292;500;501
"3453";"2. Neyman known";407;96;311;446;554
"3454";"3. RSIHR Known";446;87;359;378;622
"3455";"4. Rosenberger known";526;29;497;138;862
"3456";"5. Optimal adjusted";384;109;275;524;476
"3457";"1. Random";373;88;285;505;495
"3458";"6. Biased  coin";390;98;292;501;500
"3459";"2. Neyman known";423;90;333;451;549
"3460";"3. RSIHR Known";470;57;413;323;677
"3461";"4. Rosenberger known";555;27;528;125;875
"3462";"5. Optimal adjusted";385;105;280;520;480
"3463";"1. Random";392;108;284;508;492
"3464";"6. Biased  coin";386;107;279;506;496
"3465";"2. Neyman known";414;93;321;451;549
"3466";"3. RSIHR Known";449;76;373;375;625
"3467";"4. Rosenberger known";536;32;504;147;853
"3468";"5. Optimal adjusted";387;109;278;516;484
"3469";"1. Random";382;95;287;498;502
"3470";"6. Biased  coin";422;114;308;502;499
"3471";"2. Neyman known";416;92;324;433;567
"3472";"3. RSIHR Known";455;67;388;339;661
"3473";"4. Rosenberger known";527;26;501;144;856
"3474";"5. Optimal adjusted";384;111;273;543;457
"3475";"1. Random";387;85;302;478;522
"3476";"6. Biased  coin";381;84;297;502;500
"3477";"2. Neyman known";394;83;311;456;544
"3478";"3. RSIHR Known";443;84;359;391;609
"3479";"4. Rosenberger known";539;34;505;152;848
"3480";"5. Optimal adjusted";398;102;296;523;477
"3481";"1. Random";402;98;304;510;490
"3482";"6. Biased  coin";406;92;314;499;502
"3483";"2. Neyman known";409;83;326;473;527
"3484";"3. RSIHR Known";480;69;411;351;649
"3485";"4. Rosenberger known";568;36;532;159;841
"3486";"5. Optimal adjusted";396;106;290;551;449
"3487";"1. Random";439;112;327;490;510
"3488";"6. Biased  coin";429;113;316;496;504
"3489";"2. Neyman known";431;80;351;412;588
"3490";"3. RSIHR Known";465;86;379;381;619
"3491";"4. Rosenberger known";551;35;516;145;855
"3492";"5. Optimal adjusted";398;108;290;536;464
"3493";"1. Random";438;100;338;472;528
"3494";"6. Biased  coin";404;95;309;500;501
"3495";"2. Neyman known";430;99;331;459;541
"3496";"3. RSIHR Known";471;71;400;369;631
"3497";"4. Rosenberger known";554;30;524;153;847
"3498";"5. Optimal adjusted";393;103;290;533;467
"3499";"1. Random";376;98;278;526;474
"3500";"6. Biased  coin";400;100;300;501;500
"3501";"2. Neyman known";419;82;337;441;559
"3502";"3. RSIHR Known";461;74;387;353;647
"3503";"4. Rosenberger known";555;31;524;135;865
"3504";"5. Optimal adjusted";380;86;294;514;486
"3505";"1. Random";401;108;293;492;508
"3506";"6. Biased  coin";408;118;290;500;501
"3507";"2. Neyman known";436;103;333;445;555
"3508";"3. RSIHR Known";432;68;364;353;647
"3509";"4. Rosenberger known";517;25;492;141;859
"3510";"5. Optimal adjusted";399;129;270;550;450
"3511";"1. Random";385;91;294;509;491
"3512";"6. Biased  coin";420;105;315;500;500
"3513";"2. Neyman known";419;82;337;442;558
"3514";"3. RSIHR Known";457;70;387;369;631
"3515";"4. Rosenberger known";543;19;524;123;877
"3516";"5. Optimal adjusted";374;108;266;555;445
"3517";"1. Random";401;99;302;491;509
"3518";"6. Biased  coin";380;92;288;500;500
"3519";"2. Neyman known";405;93;312;461;539
"3520";"3. RSIHR Known";448;79;369;392;608
"3521";"4. Rosenberger known";553;33;520;135;865
"3522";"5. Optimal adjusted";390;109;281;524;476
"3523";"1. Random";421;103;318;485;515
"3524";"6. Biased  coin";407;105;302;502;498
"3525";"2. Neyman known";406;96;310;480;520
"3526";"3. RSIHR Known";468;87;381;383;617
"3527";"4. Rosenberger known";535;26;509;146;854
"3528";"5. Optimal adjusted";389;125;264;553;447
"3529";"1. Random";430;110;320;464;536
"3530";"6. Biased  coin";420;118;302;499;501
"3531";"2. Neyman known";433;109;324;469;531
"3532";"3. RSIHR Known";483;89;394;361;639
"3533";"4. Rosenberger known";550;26;524;130;870
"3534";"5. Optimal adjusted";385;108;277;545;455
"3535";"1. Random";372;110;262;518;482
"3536";"6. Biased  coin";385;96;289;499;501
"3537";"2. Neyman known";412;94;318;438;562
"3538";"3. RSIHR Known";432;78;354;376;624
"3539";"4. Rosenberger known";505;29;476;159;841
"3540";"5. Optimal adjusted";401;105;296;507;493
"3541";"1. Random";388;104;284;539;461
"3542";"6. Biased  coin";409;108;301;500;500
"3543";"2. Neyman known";430;107;323;437;563
"3544";"3. RSIHR Known";470;74;396;352;648
"3545";"4. Rosenberger known";545;35;510;138;862
"3546";"5. Optimal adjusted";382;105;277;526;474
"3547";"1. Random";425;99;326;491;509
"3548";"6. Biased  coin";413;96;317;500;500
"3549";"2. Neyman known";423;100;323;479;521
"3550";"3. RSIHR Known";472;69;403;364;636
"3551";"4. Rosenberger known";566;19;547;125;875
"3552";"5. Optimal adjusted";383;102;281;549;451
"3553";"1. Random";430;96;334;482;518
"3554";"6. Biased  coin";423;105;318;500;500
"3555";"2. Neyman known";420;99;321;481;519
"3556";"3. RSIHR Known";485;71;414;334;666
"3557";"4. Rosenberger known";573;27;546;141;859
"3558";"5. Optimal adjusted";403;103;300;521;479
"3559";"1. Random";394;94;300;498;502
"3560";"6. Biased  coin";409;103;306;500;500
"3561";"2. Neyman known";420;100;320;452;548
"3562";"3. RSIHR Known";448;74;374;367;633
"3563";"4. Rosenberger known";540;33;507;153;847
"3564";"5. Optimal adjusted";366;103;263;537;463
"3565";"1. Random";406;108;298;491;509
"3566";"6. Biased  coin";405;113;292;500;500
"3567";"2. Neyman known";438;106;332;448;552
"3568";"3. RSIHR Known";437;83;354;378;622
"3569";"4. Rosenberger known";539;33;506;149;851
"3570";"5. Optimal adjusted";392;115;277;524;476
"3571";"1. Random";406;103;303;494;506
"3572";"6. Biased  coin";375;94;281;501;500
"3573";"2. Neyman known";416;83;333;428;572
"3574";"3. RSIHR Known";447;63;384;349;651
"3575";"4. Rosenberger known";537;24;513;146;854
"3576";"5. Optimal adjusted";373;95;278;526;474
"3577";"1. Random";402;103;299;497;503
"3578";"6. Biased  coin";400;102;298;501;499
"3579";"2. Neyman known";420;91;329;458;542
"3580";"3. RSIHR Known";462;84;378;359;641
"3581";"4. Rosenberger known";522;21;501;144;856
"3582";"5. Optimal adjusted";385;107;278;524;476
"3583";"1. Random";392;93;299;485;515
"3584";"6. Biased  coin";414;106;308;500;500
"3585";"2. Neyman known";396;96;300;471;529
"3586";"3. RSIHR Known";435;73;362;383;617
"3587";"4. Rosenberger known";541;32;509;147;853
"3588";"5. Optimal adjusted";383;117;266;562;438
"3589";"1. Random";386;100;286;495;505
"3590";"6. Biased  coin";416;111;305;504;500
"3591";"2. Neyman known";401;102;299;472;528
"3592";"3. RSIHR Known";459;89;370;356;644
"3593";"4. Rosenberger known";537;28;509;125;875
"3594";"5. Optimal adjusted";380;111;269;538;462
"3595";"1. Random";428;104;324;494;506
"3596";"6. Biased  coin";404;98;306;501;500
"3597";"2. Neyman known";426;93;333;464;536
"3598";"3. RSIHR Known";468;70;398;348;652
"3599";"4. Rosenberger known";561;32;529;147;853
"3600";"5. Optimal adjusted";381;116;265;559;441
"3601";"1. Random";392;91;301;474;526
"3602";"6. Biased  coin";402;99;303;501;500
"3603";"2. Neyman known";424;94;330;449;551
"3604";"3. RSIHR Known";439;69;370;362;638
"3605";"4. Rosenberger known";539;22;517;134;866
"3606";"5. Optimal adjusted";382;115;267;569;431
"3607";"1. Random";383;95;288;483;517
"3608";"6. Biased  coin";363;83;280;500;500
"3609";"2. Neyman known";422;87;335;432;568
"3610";"3. RSIHR Known";429;68;361;368;632
"3611";"4. Rosenberger known";520;24;496;141;859
"3612";"5. Optimal adjusted";359;98;261;552;448
"3613";"1. Random";390;97;293;504;496
"3614";"6. Biased  coin";402;106;296;501;500
"3615";"2. Neyman known";415;92;323;445;555
"3616";"3. RSIHR Known";450;60;390;351;649
"3617";"4. Rosenberger known";534;31;503;149;851
"3618";"5. Optimal adjusted";405;106;299;516;484
"3619";"1. Random";409;113;296;494;506
"3620";"6. Biased  coin";397;102;295;501;500
"3621";"2. Neyman known";415;81;334;429;571
"3622";"3. RSIHR Known";453;77;376;371;629
"3623";"4. Rosenberger known";548;38;510;159;841
"3624";"5. Optimal adjusted";409;108;301;514;486
"3625";"1. Random";413;115;298;526;474
"3626";"6. Biased  coin";417;108;309;498;502
"3627";"2. Neyman known";388;92;296;464;536
"3628";"3. RSIHR Known";437;77;360;377;623
"3629";"4. Rosenberger known";529;22;507;140;860
"3630";"5. Optimal adjusted";372;108;264;539;461
"3631";"1. Random";406;102;304;493;507
"3632";"6. Biased  coin";403;101;302;500;501
"3633";"2. Neyman known";416;86;330;443;557
"3634";"3. RSIHR Known";452;72;380;366;634
"3635";"4. Rosenberger known";537;31;506;150;850
"3636";"5. Optimal adjusted";377;116;261;540;460
"3637";"1. Random";378;93;285;508;492
"3638";"6. Biased  coin";380;102;278;502;499
"3639";"2. Neyman known";413;84;329;454;546
"3640";"3. RSIHR Known";430;74;356;376;624
"3641";"4. Rosenberger known";521;24;497;145;855
"3642";"5. Optimal adjusted";374;112;262;537;463
"3643";"1. Random";410;91;319;473;527
"3644";"6. Biased  coin";412;97;315;501;500
"3645";"2. Neyman known";433;98;335;456;544
"3646";"3. RSIHR Known";448;72;376;373;627
"3647";"4. Rosenberger known";544;25;519;142;858
"3648";"5. Optimal adjusted";411;108;303;518;482
"3649";"1. Random";413;97;316;461;539
"3650";"6. Biased  coin";401;105;296;504;498
"3651";"2. Neyman known";435;96;339;458;542
"3652";"3. RSIHR Known";467;91;376;372;628
"3653";"4. Rosenberger known";530;30;500;147;853
"3654";"5. Optimal adjusted";392;106;286;504;496
"3655";"1. Random";400;100;300;502;498
"3656";"6. Biased  coin";388;96;292;504;500
"3657";"2. Neyman known";443;86;357;430;570
"3658";"3. RSIHR Known";452;77;375;385;615
"3659";"4. Rosenberger known";550;35;515;155;845
"3660";"5. Optimal adjusted";413;119;294;531;469
"3661";"1. Random";375;91;284;479;521
"3662";"6. Biased  coin";387;103;284;501;499
"3663";"2. Neyman known";378;81;297;455;545
"3664";"3. RSIHR Known";443;65;378;330;670
"3665";"4. Rosenberger known";519;25;494;136;864
"3666";"5. Optimal adjusted";367;108;259;551;449
"3667";"1. Random";419;106;313;489;511
"3668";"6. Biased  coin";393;93;300;501;500
"3669";"2. Neyman known";428;91;337;445;555
"3670";"3. RSIHR Known";457;63;394;339;661
"3671";"4. Rosenberger known";557;37;520;149;851
"3672";"5. Optimal adjusted";355;98;257;560;440
"3673";"1. Random";401;99;302;500;500
"3674";"6. Biased  coin";376;99;277;502;499
"3675";"2. Neyman known";391;97;294;458;542
"3676";"3. RSIHR Known";446;81;365;354;646
"3677";"4. Rosenberger known";504;34;470;164;836
"3678";"5. Optimal adjusted";381;114;267;525;475
"3679";"1. Random";394;100;294;515;485
"3680";"6. Biased  coin";405;96;309;497;503
"3681";"2. Neyman known";423;92;331;477;523
"3682";"3. RSIHR Known";464;63;401;356;644
"3683";"4. Rosenberger known";552;30;522;150;850
"3684";"5. Optimal adjusted";365;106;259;561;439
"3685";"1. Random";406;100;306;480;520
"3686";"6. Biased  coin";382;98;284;502;500
"3687";"2. Neyman known";429;88;341;439;561
"3688";"3. RSIHR Known";442;77;365;371;629
"3689";"4. Rosenberger known";536;28;508;133;867
"3690";"5. Optimal adjusted";390;110;280;515;485
"3691";"1. Random";415;102;313;469;531
"3692";"6. Biased  coin";406;115;291;503;499
"3693";"2. Neyman known";390;86;304;454;546
"3694";"3. RSIHR Known";447;71;376;350;650
"3695";"4. Rosenberger known";513;29;484;154;846
"3696";"5. Optimal adjusted";390;114;276;537;463
"3697";"1. Random";384;113;271;523;477
"3698";"6. Biased  coin";382;107;275;500;500
"3699";"2. Neyman known";404;109;295;468;532
"3700";"3. RSIHR Known";433;82;351;389;611
"3701";"4. Rosenberger known";517;31;486;157;843
"3702";"5. Optimal adjusted";378;122;256;547;453
"3703";"1. Random";399;109;290;504;496
"3704";"6. Biased  coin";404;110;294;500;500
"3705";"2. Neyman known";429;108;321;450;550
"3706";"3. RSIHR Known";449;73;376;361;639
"3707";"4. Rosenberger known";558;26;532;127;873
"3708";"5. Optimal adjusted";410;119;291;528;472
"3709";"1. Random";431;123;308;481;519
"3710";"6. Biased  coin";436;132;304;501;500
"3711";"2. Neyman known";425;114;311;487;513
"3712";"3. RSIHR Known";472;84;388;365;635
"3713";"4. Rosenberger known";552;41;511;145;855
"3714";"5. Optimal adjusted";421;126;295;534;466
"3715";"1. Random";403;116;287;517;483
"3716";"6. Biased  coin";440;131;309;500;500
"3717";"2. Neyman known";433;95;338;451;549
"3718";"3. RSIHR Known";462;84;378;361;639
"3719";"4. Rosenberger known";558;43;515;148;852
"3720";"5. Optimal adjusted";380;136;244;566;434
"3721";"1. Random";372;80;292;504;496
"3722";"6. Biased  coin";364;84;280;501;499
"3723";"2. Neyman known";406;83;323;436;564
"3724";"3. RSIHR Known";421;68;353;384;616
"3725";"4. Rosenberger known";511;29;482;147;853
"3726";"5. Optimal adjusted";361;94;267;531;469
"3727";"1. Random";415;105;310;516;484
"3728";"6. Biased  coin";410;111;299;501;499
"3729";"2. Neyman known";428;92;336;450;550
"3730";"3. RSIHR Known";459;64;395;367;633
"3731";"4. Rosenberger known";559;42;517;150;850
"3732";"5. Optimal adjusted";365;104;261;565;435
"3733";"1. Random";433;118;315;485;515
"3734";"6. Biased  coin";408;113;295;500;500
"3735";"2. Neyman known";447;115;332;439;561
"3736";"3. RSIHR Known";476;88;388;356;644
"3737";"4. Rosenberger known";549;28;521;146;854
"3738";"5. Optimal adjusted";404;129;275;538;462
"3739";"1. Random";425;106;319;469;531
"3740";"6. Biased  coin";409;110;299;497;503
"3741";"2. Neyman known";436;107;329;442;558
"3742";"3. RSIHR Known";468;80;388;357;643
"3743";"4. Rosenberger known";547;18;529;113;887
"3744";"5. Optimal adjusted";395;116;279;519;481
"3745";"1. Random";398;99;299;489;511
"3746";"6. Biased  coin";402;106;296;501;499
"3747";"2. Neyman known";396;80;316;442;558
"3748";"3. RSIHR Known";434;65;369;363;637
"3749";"4. Rosenberger known";523;35;488;154;846
"3750";"5. Optimal adjusted";382;120;262;543;457
"3751";"1. Random";396;103;293;503;497
"3752";"6. Biased  coin";408;111;297;501;499
"3753";"2. Neyman known";447;105;342;429;571
"3754";"3. RSIHR Known";453;83;370;372;628
"3755";"4. Rosenberger known";546;36;510;145;855
"3756";"5. Optimal adjusted";412;119;293;518;482
"3757";"1. Random";403;109;294;498;502
"3758";"6. Biased  coin";378;94;284;504;499
"3759";"2. Neyman known";415;98;317;458;542
"3760";"3. RSIHR Known";473;88;385;363;637
"3761";"4. Rosenberger known";532;33;499;139;861
"3762";"5. Optimal adjusted";364;111;253;542;458
"3763";"1. Random";380;87;293;504;496
"3764";"6. Biased  coin";394;105;289;500;500
"3765";"2. Neyman known";424;91;333;443;557
"3766";"3. RSIHR Known";472;78;394;351;649
"3767";"4. Rosenberger known";537;29;508;145;855
"3768";"5. Optimal adjusted";383;111;272;549;451
"3769";"1. Random";413;108;305;489;511
"3770";"6. Biased  coin";404;101;303;500;500
"3771";"2. Neyman known";418;107;311;468;532
"3772";"3. RSIHR Known";455;75;380;354;646
"3773";"4. Rosenberger known";531;28;503;134;866
"3774";"5. Optimal adjusted";363;117;246;564;436
"3775";"1. Random";391;98;293;509;491
"3776";"6. Biased  coin";398;107;291;502;500
"3777";"2. Neyman known";412;85;327;460;540
"3778";"3. RSIHR Known";476;68;408;355;645
"3779";"4. Rosenberger known";555;39;516;138;862
"3780";"5. Optimal adjusted";391;101;290;518;482
"3781";"1. Random";381;92;289;509;491
"3782";"6. Biased  coin";417;109;308;501;500
"3783";"2. Neyman known";420;98;322;465;535
"3784";"3. RSIHR Known";473;76;397;355;645
"3785";"4. Rosenberger known";541;40;501;161;839
"3786";"5. Optimal adjusted";397;120;277;547;453
"3787";"1. Random";391;94;297;485;515
"3788";"6. Biased  coin";377;97;280;501;499
"3789";"2. Neyman known";412;92;320;462;538
"3790";"3. RSIHR Known";433;68;365;357;643
"3791";"4. Rosenberger known";528;28;500;142;858
"3792";"5. Optimal adjusted";404;103;301;501;499
"3793";"1. Random";388;101;287;510;490
"3794";"6. Biased  coin";401;109;292;500;500
"3795";"2. Neyman known";428;84;344;414;586
"3796";"3. RSIHR Known";447;73;374;360;640
"3797";"4. Rosenberger known";534;35;499;166;834
"3798";"5. Optimal adjusted";393;109;284;529;471
"3799";"1. Random";389;101;288;492;508
"3800";"6. Biased  coin";391;99;292;500;500
"3801";"2. Neyman known";403;90;313;454;546
"3802";"3. RSIHR Known";454;86;368;370;630
"3803";"4. Rosenberger known";527;23;504;144;856
"3804";"5. Optimal adjusted";396;112;284;528;472
"3805";"1. Random";390;99;291;505;495
"3806";"6. Biased  coin";372;84;288;501;500
"3807";"2. Neyman known";406;98;308;465;535
"3808";"3. RSIHR Known";450;67;383;336;664
"3809";"4. Rosenberger known";522;29;493;151;849
"3810";"5. Optimal adjusted";373;105;268;539;461
"3811";"1. Random";404;92;312;489;511
"3812";"6. Biased  coin";404;105;299;503;498
"3813";"2. Neyman known";434;103;331;444;556
"3814";"3. RSIHR Known";479;70;409;323;677
"3815";"4. Rosenberger known";539;29;510;146;854
"3816";"5. Optimal adjusted";380;126;254;559;441
"3817";"1. Random";368;83;285;504;496
"3818";"6. Biased  coin";388;95;293;501;500
"3819";"2. Neyman known";422;88;334;450;550
"3820";"3. RSIHR Known";443;69;374;368;632
"3821";"4. Rosenberger known";532;20;512;135;865
"3822";"5. Optimal adjusted";364;103;261;540;460
"3823";"1. Random";411;103;308;512;488
"3824";"6. Biased  coin";405;98;307;503;499
"3825";"2. Neyman known";441;94;347;430;570
"3826";"3. RSIHR Known";461;67;394;361;639
"3827";"4. Rosenberger known";560;20;540;118;882
"3828";"5. Optimal adjusted";393;106;287;540;460
"3829";"1. Random";395;106;289;490;510
"3830";"6. Biased  coin";415;115;300;502;498
"3831";"2. Neyman known";413;92;321;454;546
"3832";"3. RSIHR Known";445;78;367;374;626
"3833";"4. Rosenberger known";544;21;523;110;890
"3834";"5. Optimal adjusted";394;110;284;529;471
"3835";"1. Random";409;84;325;462;538
"3836";"6. Biased  coin";402;106;296;502;500
"3837";"2. Neyman known";440;89;351;432;568
"3838";"3. RSIHR Known";446;78;368;388;612
"3839";"4. Rosenberger known";528;28;500;164;836
"3840";"5. Optimal adjusted";388;92;296;506;494
"3841";"1. Random";415;106;309;489;511
"3842";"6. Biased  coin";418;103;315;504;499
"3843";"2. Neyman known";425;86;339;439;561
"3844";"3. RSIHR Known";489;88;401;362;638
"3845";"4. Rosenberger known";554;29;525;132;868
"3846";"5. Optimal adjusted";396;114;282;545;455
"3847";"1. Random";381;98;283;505;495
"3848";"6. Biased  coin";392;102;290;501;500
"3849";"2. Neyman known";391;92;299;467;533
"3850";"3. RSIHR Known";453;77;376;340;660
"3851";"4. Rosenberger known";519;28;491;130;870
"3852";"5. Optimal adjusted";378;115;263;543;457
"3853";"1. Random";388;104;284;523;477
"3854";"6. Biased  coin";391;98;293;501;500
"3855";"2. Neyman known";432;79;353;422;578
"3856";"3. RSIHR Known";462;71;391;363;637
"3857";"4. Rosenberger known";551;31;520;145;855
"3858";"5. Optimal adjusted";369;107;262;558;442
"3859";"1. Random";404;109;295;500;500
"3860";"6. Biased  coin";400;110;290;501;500
"3861";"2. Neyman known";419;106;313;446;554
"3862";"3. RSIHR Known";437;81;356;365;635
"3863";"4. Rosenberger known";523;28;495;129;871
"3864";"5. Optimal adjusted";362;99;263;530;470
"3865";"1. Random";429;119;310;490;510
"3866";"6. Biased  coin";413;107;306;501;500
"3867";"2. Neyman known";414;96;318;460;540
"3868";"3. RSIHR Known";451;75;376;362;638
"3869";"4. Rosenberger known";541;33;508;134;866
"3870";"5. Optimal adjusted";408;120;288;525;475
"3871";"1. Random";381;93;288;493;507
"3872";"6. Biased  coin";360;80;280;500;500
"3873";"2. Neyman known";418;93;325;446;554
"3874";"3. RSIHR Known";436;65;371;341;659
"3875";"4. Rosenberger known";502;27;475;153;847
"3876";"5. Optimal adjusted";344;107;237;557;443
"3877";"1. Random";393;96;297;505;495
"3878";"6. Biased  coin";397;98;299;500;500
"3879";"2. Neyman known";425;90;335;441;559
"3880";"3. RSIHR Known";449;71;378;360;640
"3881";"4. Rosenberger known";532;32;500;165;835
"3882";"5. Optimal adjusted";389;109;280;525;475
"3883";"1. Random";391;106;285;518;482
"3884";"6. Biased  coin";398;113;285;500;500
"3885";"2. Neyman known";432;101;331;448;552
"3886";"3. RSIHR Known";435;72;363;368;632
"3887";"4. Rosenberger known";522;30;492;152;848
"3888";"5. Optimal adjusted";362;94;268;516;484
"3889";"1. Random";401;117;284;537;463
"3890";"6. Biased  coin";392;103;289;502;499
"3891";"2. Neyman known";397;88;309;474;526
"3892";"3. RSIHR Known";452;80;372;362;638
"3893";"4. Rosenberger known";529;28;501;140;860
"3894";"5. Optimal adjusted";406;105;301;504;496
"3895";"1. Random";399;104;295;489;511
"3896";"6. Biased  coin";383;103;280;503;497
"3897";"2. Neyman known";408;100;308;480;520
"3898";"3. RSIHR Known";460;66;394;352;648
"3899";"4. Rosenberger known";526;27;499;146;854
"3900";"5. Optimal adjusted";367;116;251;552;448
"3901";"1. Random";382;92;290;506;494
"3902";"6. Biased  coin";384;87;297;499;501
"3903";"2. Neyman known";408;94;314;464;536
"3904";"3. RSIHR Known";443;73;370;389;611
"3905";"4. Rosenberger known";530;26;504;151;849
"3906";"5. Optimal adjusted";376;99;277;535;465
"3907";"1. Random";391;98;293;492;508
"3908";"6. Biased  coin";404;107;297;499;501
"3909";"2. Neyman known";422;91;331;452;548
"3910";"3. RSIHR Known";445;72;373;381;619
"3911";"4. Rosenberger known";558;36;522;151;849
"3912";"5. Optimal adjusted";377;108;269;560;440
"3913";"1. Random";380;105;275;499;501
"3914";"6. Biased  coin";405;121;284;497;503
"3915";"2. Neyman known";398;96;302;442;558
"3916";"3. RSIHR Known";435;82;353;350;650
"3917";"4. Rosenberger known";516;38;478;150;850
"3918";"5. Optimal adjusted";382;124;258;531;469
"3919";"1. Random";410;102;308;488;512
"3920";"6. Biased  coin";374;93;281;500;500
"3921";"2. Neyman known";411;88;323;450;550
"3922";"3. RSIHR Known";443;79;364;371;629
"3923";"4. Rosenberger known";538;28;510;141;859
"3924";"5. Optimal adjusted";388;101;287;514;486
"3925";"1. Random";407;119;288;513;487
"3926";"6. Biased  coin";394;111;283;500;500
"3927";"2. Neyman known";413;101;312;456;544
"3928";"3. RSIHR Known";457;83;374;364;636
"3929";"4. Rosenberger known";530;32;498;136;864
"3930";"5. Optimal adjusted";403;116;287;522;478
"3931";"1. Random";412;94;318;471;529
"3932";"6. Biased  coin";399;106;293;500;500
"3933";"2. Neyman known";402;94;308;461;539
"3934";"3. RSIHR Known";469;68;401;342;658
"3935";"4. Rosenberger known";541;35;506;146;854
"3936";"5. Optimal adjusted";404;113;291;526;474
"3937";"1. Random";419;110;309;495;505
"3938";"6. Biased  coin";408;113;295;499;502
"3939";"2. Neyman known";431;99;332;433;567
"3940";"3. RSIHR Known";447;91;356;391;609
"3941";"4. Rosenberger known";536;35;501;154;846
"3942";"5. Optimal adjusted";376;116;260;546;454
"3943";"1. Random";406;112;294;504;496
"3944";"6. Biased  coin";397;105;292;501;499
"3945";"2. Neyman known";439;92;347;420;580
"3946";"3. RSIHR Known";482;89;393;380;620
"3947";"4. Rosenberger known";544;35;509;137;863
"3948";"5. Optimal adjusted";401;119;282;533;467
"3949";"1. Random";412;105;307;488;512
"3950";"6. Biased  coin";408;103;305;501;500
"3951";"2. Neyman known";421;105;316;458;542
"3952";"3. RSIHR Known";453;87;366;375;625
"3953";"4. Rosenberger known";526;33;493;164;836
"3954";"5. Optimal adjusted";398;122;276;535;465
"3955";"1. Random";396;98;298;497;503
"3956";"6. Biased  coin";377;89;288;501;501
"3957";"2. Neyman known";378;83;295;475;525
"3958";"3. RSIHR Known";446;75;371;373;627
"3959";"4. Rosenberger known";511;23;488;153;847
"3960";"5. Optimal adjusted";384;113;271;539;461
"3961";"1. Random";387;98;289;502;498
"3962";"6. Biased  coin";405;107;298;498;503
"3963";"2. Neyman known";406;85;321;450;550
"3964";"3. RSIHR Known";451;69;382;363;637
"3965";"4. Rosenberger known";530;26;504;143;857
"3966";"5. Optimal adjusted";384;103;281;536;464
"3967";"1. Random";394;94;300;478;522
"3968";"6. Biased  coin";388;100;288;502;499
"3969";"2. Neyman known";395;76;319;448;552
"3970";"3. RSIHR Known";419;66;353;353;647
"3971";"4. Rosenberger known";525;31;494;149;851
"3972";"5. Optimal adjusted";379;107;272;544;456
"3973";"1. Random";402;104;298;495;505
"3974";"6. Biased  coin";396;104;292;500;500
"3975";"2. Neyman known";410;90;320;471;529
"3976";"3. RSIHR Known";461;79;382;370;630
"3977";"4. Rosenberger known";539;31;508;146;854
"3978";"5. Optimal adjusted";377;110;267;533;467
"3979";"1. Random";412;116;296;509;491
"3980";"6. Biased  coin";407;105;302;501;499
"3981";"2. Neyman known";418;89;329;445;555
"3982";"3. RSIHR Known";463;72;391;364;636
"3983";"4. Rosenberger known";533;27;506;146;854
"3984";"5. Optimal adjusted";395;112;283;531;469
"3985";"1. Random";392;105;287;501;499
"3986";"6. Biased  coin";365;94;271;497;503
"3987";"2. Neyman known";410;92;318;436;564
"3988";"3. RSIHR Known";436;77;359;385;615
"3989";"4. Rosenberger known";524;24;500;126;874
"3990";"5. Optimal adjusted";375;121;254;561;439
"3991";"1. Random";387;88;299;491;509
"3992";"6. Biased  coin";378;91;287;500;500
"3993";"2. Neyman known";423;94;329;433;567
"3994";"3. RSIHR Known";436;74;362;371;629
"3995";"4. Rosenberger known";534;34;500;141;859
"3996";"5. Optimal adjusted";370;111;259;544;456
"3997";"1. Random";410;115;295;500;500
"3998";"6. Biased  coin";383;102;281;500;500
"3999";"2. Neyman known";397;84;313;456;544
"4000";"3. RSIHR Known";446;78;368;359;641
"4001";"4. Rosenberger known";540;32;508;135;865
"4002";"5. Optimal adjusted";373;126;247;562;438
"4003";"1. Random";394;110;284;515;485
"4004";"6. Biased  coin";398;107;291;499;501
"4005";"2. Neyman known";405;91;314;453;547
"4006";"3. RSIHR Known";435;67;368;373;627
"4007";"4. Rosenberger known";527;24;503;148;852
"4008";"5. Optimal adjusted";386;111;275;522;478
"4009";"1. Random";390;105;285;479;521
"4010";"6. Biased  coin";377;105;272;501;499
"4011";"2. Neyman known";401;88;313;432;568
"4012";"3. RSIHR Known";425;81;344;378;622
"4013";"4. Rosenberger known";518;25;493;126;874
"4014";"5. Optimal adjusted";373;119;254;536;464
"4015";"1. Random";384;105;279;518;482
"4016";"6. Biased  coin";414;104;310;499;501
"4017";"2. Neyman known";417;101;316;467;533
"4018";"3. RSIHR Known";473;81;392;364;636
"4019";"4. Rosenberger known";536;31;505;158;842
"4020";"5. Optimal adjusted";384;122;262;545;455
"4021";"1. Random";389;102;287;521;479
"4022";"6. Biased  coin";390;103;287;502;499
"4023";"2. Neyman known";427;91;336;446;554
"4024";"3. RSIHR Known";459;83;376;382;618
"4025";"4. Rosenberger known";528;33;495;154;846
"4026";"5. Optimal adjusted";359;107;252;567;433
"4027";"1. Random";395;106;289;512;488
"4028";"6. Biased  coin";402;96;306;500;501
"4029";"2. Neyman known";433;83;350;419;581
"4030";"3. RSIHR Known";467;71;396;346;654
"4031";"4. Rosenberger known";551;29;522;134;866
"4032";"5. Optimal adjusted";383;100;283;537;463
"4033";"1. Random";428;107;321;494;506
"4034";"6. Biased  coin";412;96;316;500;500
"4035";"2. Neyman known";406;77;329;440;560
"4036";"3. RSIHR Known";449;75;374;381;619
"4037";"4. Rosenberger known";551;25;526;141;859
"4038";"5. Optimal adjusted";404;105;299;522;478
"4039";"1. Random";412;112;300;505;495
"4040";"6. Biased  coin";395;106;289;503;498
"4041";"2. Neyman known";426;106;320;465;535
"4042";"3. RSIHR Known";464;80;384;371;629
"4043";"4. Rosenberger known";525;27;498;142;858
"4044";"5. Optimal adjusted";382;102;280;538;462
"4045";"1. Random";357;96;261;530;470
"4046";"6. Biased  coin";384;91;293;499;501
"4047";"2. Neyman known";414;74;340;413;587
"4048";"3. RSIHR Known";448;65;383;337;663
"4049";"4. Rosenberger known";528;26;502;127;873
"4050";"5. Optimal adjusted";365;103;262;537;463
"4051";"1. Random";397;96;301;510;490
"4052";"6. Biased  coin";411;112;299;500;500
"4053";"2. Neyman known";435;101;334;459;541
"4054";"3. RSIHR Known";462;67;395;373;627
"4055";"4. Rosenberger known";556;30;526;145;855
"4056";"5. Optimal adjusted";401;109;292;525;475
"4057";"1. Random";425;109;316;494;506
"4058";"6. Biased  coin";420;105;315;504;497
"4059";"2. Neyman known";433;102;331;457;543
"4060";"3. RSIHR Known";485;73;412;352;648
"4061";"4. Rosenberger known";557;33;524;157;843
"4062";"5. Optimal adjusted";410;113;297;534;466
"4063";"1. Random";415;103;312;495;505
"4064";"6. Biased  coin";407;105;302;501;500
"4065";"2. Neyman known";424;85;339;435;565
"4066";"3. RSIHR Known";464;77;387;368;632
"4067";"4. Rosenberger known";548;30;518;134;866
"4068";"5. Optimal adjusted";396;110;286;528;472
"4069";"1. Random";453;115;338;481;519
"4070";"6. Biased  coin";397;98;299;504;497
"4071";"2. Neyman known";418;102;316;463;537
"4072";"3. RSIHR Known";470;67;403;348;652
"4073";"4. Rosenberger known";551;32;519;152;848
"4074";"5. Optimal adjusted";398;119;279;524;476
"4075";"1. Random";399;108;291;502;498
"4076";"6. Biased  coin";420;116;304;501;500
"4077";"2. Neyman known";419;90;329;444;556
"4078";"3. RSIHR Known";451;80;371;363;637
"4079";"4. Rosenberger known";545;44;501;157;843
"4080";"5. Optimal adjusted";392;113;279;525;475
"4081";"1. Random";372;78;294;479;521
"4082";"6. Biased  coin";394;97;297;502;499
"4083";"2. Neyman known";404;77;327;442;558
"4084";"3. RSIHR Known";423;69;354;377;623
"4085";"4. Rosenberger known";505;28;477;161;839
"4086";"5. Optimal adjusted";373;90;283;525;475
"4087";"1. Random";421;98;323;492;508
"4088";"6. Biased  coin";410;104;306;500;501
"4089";"2. Neyman known";402;96;306;480;520
"4090";"3. RSIHR Known";457;77;380;366;634
"4091";"4. Rosenberger known";560;23;537;126;874
"4092";"5. Optimal adjusted";393;118;275;560;440
"4093";"1. Random";406;115;291;494;506
"4094";"6. Biased  coin";404;117;287;501;500
"4095";"2. Neyman known";401;93;308;466;534
"4096";"3. RSIHR Known";445;72;373;372;628
"4097";"4. Rosenberger known";527;28;499;143;857
"4098";"5. Optimal adjusted";398;120;278;543;457
"4099";"1. Random";421;113;308;507;493
"4100";"6. Biased  coin";408;102;306;501;500
"4101";"2. Neyman known";407;94;313;464;536
"4102";"3. RSIHR Known";470;66;404;360;640
"4103";"4. Rosenberger known";558;25;533;125;875
"4104";"5. Optimal adjusted";390;102;288;524;476
"4105";"1. Random";398;97;301;476;524
"4106";"6. Biased  coin";383;97;286;500;500
"4107";"2. Neyman known";407;87;320;448;552
"4108";"3. RSIHR Known";443;75;368;371;629
"4109";"4. Rosenberger known";532;33;499;157;843
"4110";"5. Optimal adjusted";401;127;274;530;470
"4111";"1. Random";412;114;298;505;495
"4112";"6. Biased  coin";404;106;298;503;499
"4113";"2. Neyman known";433;97;336;453;547
"4114";"3. RSIHR Known";472;69;403;344;656
"4115";"4. Rosenberger known";555;30;525;134;866
"4116";"5. Optimal adjusted";412;120;292;535;465
"4117";"1. Random";402;100;302;491;509
"4118";"6. Biased  coin";379;94;285;501;500
"4119";"2. Neyman known";426;90;336;447;553
"4120";"3. RSIHR Known";458;69;389;343;657
"4121";"4. Rosenberger known";526;26;500;139;861
"4122";"5. Optimal adjusted";359;88;271;520;480
"4123";"1. Random";389;103;286;532;468
"4124";"6. Biased  coin";395;108;287;498;503
"4125";"2. Neyman known";404;90;314;446;554
"4126";"3. RSIHR Known";463;73;390;364;636
"4127";"4. Rosenberger known";530;29;501;141;859
"4128";"5. Optimal adjusted";368;115;253;558;442
"4129";"1. Random";375;88;287;497;503
"4130";"6. Biased  coin";397;96;301;503;500
"4131";"2. Neyman known";401;90;311;454;546
"4132";"3. RSIHR Known";441;65;376;345;655
"4133";"4. Rosenberger known";513;24;489;143;857
"4134";"5. Optimal adjusted";368;107;261;536;464
"4135";"1. Random";388;112;276;521;479
"4136";"6. Biased  coin";387;96;291;500;500
"4137";"2. Neyman known";402;95;307;473;527
"4138";"3. RSIHR Known";433;76;357;379;621
"4139";"4. Rosenberger known";519;36;483;162;838
"4140";"5. Optimal adjusted";376;106;270;537;463
"4141";"1. Random";373;84;289;502;498
"4142";"6. Biased  coin";385;95;290;500;501
"4143";"2. Neyman known";412;69;343;434;566
"4144";"3. RSIHR Known";439;62;377;380;620
"4145";"4. Rosenberger known";538;27;511;140;860
"4146";"5. Optimal adjusted";375;102;273;534;466
"4147";"1. Random";410;104;306;482;518
"4148";"6. Biased  coin";418;112;306;499;501
"4149";"2. Neyman known";446;106;340;460;540
"4150";"3. RSIHR Known";475;69;406;338;662
"4151";"4. Rosenberger known";570;37;533;136;864
"4152";"5. Optimal adjusted";413;115;298;521;479
"4153";"1. Random";385;108;277;529;471
"4154";"6. Biased  coin";384;89;295;500;500
"4155";"2. Neyman known";418;88;330;466;534
"4156";"3. RSIHR Known";449;92;357;402;598
"4157";"4. Rosenberger known";560;39;521;146;854
"4158";"5. Optimal adjusted";396;108;288;529;471
"4159";"1. Random";382;102;280;518;482
"4160";"6. Biased  coin";426;118;308;500;500
"4161";"2. Neyman known";412;103;309;471;529
"4162";"3. RSIHR Known";450;79;371;362;638
"4163";"4. Rosenberger known";536;30;506;138;862
"4164";"5. Optimal adjusted";366;118;248;567;433
"4165";"1. Random";418;106;312;495;505
"4166";"6. Biased  coin";414;103;311;500;500
"4167";"2. Neyman known";416;81;335;453;547
"4168";"3. RSIHR Known";468;74;394;379;621
"4169";"4. Rosenberger known";565;29;536;128;872
"4170";"5. Optimal adjusted";382;110;272;558;442
"4171";"1. Random";389;106;283;498;502
"4172";"6. Biased  coin";382;99;283;500;500
"4173";"2. Neyman known";417;97;320;456;544
"4174";"3. RSIHR Known";419;65;354;382;618
"4175";"4. Rosenberger known";543;42;501;151;849
"4176";"5. Optimal adjusted";381;111;270;542;458
"4177";"1. Random";414;106;308;511;489
"4178";"6. Biased  coin";409;103;306;501;500
"4179";"2. Neyman known";411;107;304;479;521
"4180";"3. RSIHR Known";459;77;382;363;637
"4181";"4. Rosenberger known";538;37;501;161;839
"4182";"5. Optimal adjusted";399;105;294;507;493
"4183";"1. Random";400;98;302;494;506
"4184";"6. Biased  coin";406;106;300;502;500
"4185";"2. Neyman known";389;83;306;456;544
"4186";"3. RSIHR Known";441;59;382;341;659
"4187";"4. Rosenberger known";520;28;492;160;840
"4188";"5. Optimal adjusted";371;111;260;561;439
"4189";"1. Random";400;110;290;484;516
"4190";"6. Biased  coin";380;108;272;503;499
"4191";"2. Neyman known";405;95;310;460;540
"4192";"3. RSIHR Known";438;72;366;375;625
"4193";"4. Rosenberger known";525;35;490;149;851
"4194";"5. Optimal adjusted";400;115;285;516;484
"4195";"1. Random";404;104;300;511;489
"4196";"6. Biased  coin";409;116;293;502;500
"4197";"2. Neyman known";434;93;341;442;558
"4198";"3. RSIHR Known";445;72;373;375;625
"4199";"4. Rosenberger known";552;30;522;134;866
"4200";"5. Optimal adjusted";405;123;282;523;477
"4201";"1. Random";388;90;298;490;510
"4202";"6. Biased  coin";409;104;305;499;501
"4203";"2. Neyman known";445;91;354;431;569
"4204";"3. RSIHR Known";452;81;371;368;632
"4205";"4. Rosenberger known";539;22;517;134;866
"4206";"5. Optimal adjusted";371;106;265;525;475
"4207";"1. Random";396;96;300;488;512
"4208";"6. Biased  coin";430;111;319;500;501
"4209";"2. Neyman known";384;96;288;491;509
"4210";"3. RSIHR Known";436;72;364;386;614
"4211";"4. Rosenberger known";539;35;504;157;843
"4212";"5. Optimal adjusted";392;111;281;527;473
"4213";"1. Random";392;99;293;480;520
"4214";"6. Biased  coin";384;103;281;500;500
"4215";"2. Neyman known";387;88;299;469;531
"4216";"3. RSIHR Known";431;74;357;377;623
"4217";"4. Rosenberger known";523;22;501;122;878
"4218";"5. Optimal adjusted";368;101;267;534;466
"4219";"1. Random";409;111;298;523;477
"4220";"6. Biased  coin";419;109;310;500;500
"4221";"2. Neyman known";427;91;336;444;556
"4222";"3. RSIHR Known";469;78;391;359;641
"4223";"4. Rosenberger known";551;18;533;114;886
"4224";"5. Optimal adjusted";395;113;282;532;468
"4225";"1. Random";400;109;291;507;493
"4226";"6. Biased  coin";392;113;279;501;500
"4227";"2. Neyman known";415;96;319;439;561
"4228";"3. RSIHR Known";444;80;364;362;638
"4229";"4. Rosenberger known";542;34;508;131;869
"4230";"5. Optimal adjusted";392;105;287;513;487
"4231";"1. Random";377;93;284;506;494
"4232";"6. Biased  coin";367;86;281;501;499
"4233";"2. Neyman known";404;75;329;438;562
"4234";"3. RSIHR Known";426;77;349;378;622
"4235";"4. Rosenberger known";536;39;497;146;854
"4236";"5. Optimal adjusted";376;105;271;527;473
"4237";"1. Random";398;126;272;524;476
"4238";"6. Biased  coin";408;106;302;500;500
"4239";"2. Neyman known";419;105;314;464;536
"4240";"3. RSIHR Known";463;84;379;373;627
"4241";"4. Rosenberger known";547;33;514;141;859
"4242";"5. Optimal adjusted";377;119;258;552;448
"4243";"1. Random";413;96;317;478;522
"4244";"6. Biased  coin";409;105;304;501;500
"4245";"2. Neyman known";436;98;338;445;555
"4246";"3. RSIHR Known";465;82;383;381;619
"4247";"4. Rosenberger known";545;30;515;157;843
"4248";"5. Optimal adjusted";425;109;316;526;474
"4249";"1. Random";401;113;288;508;492
"4250";"6. Biased  coin";411;107;304;500;500
"4251";"2. Neyman known";407;92;315;462;538
"4252";"3. RSIHR Known";466;84;382;358;642
"4253";"4. Rosenberger known";536;20;516;124;876
"4254";"5. Optimal adjusted";400;120;280;537;463
"4255";"1. Random";409;113;296;510;490
"4256";"6. Biased  coin";402;105;297;501;500
"4257";"2. Neyman known";422;94;328;451;549
"4258";"3. RSIHR Known";454;76;378;358;642
"4259";"4. Rosenberger known";539;29;510;135;865
"4260";"5. Optimal adjusted";399;111;288;529;471
"4261";"1. Random";381;91;290;474;526
"4262";"6. Biased  coin";387;91;296;499;501
"4263";"2. Neyman known";406;82;324;444;556
"4264";"3. RSIHR Known";447;72;375;388;612
"4265";"4. Rosenberger known";540;33;507;135;865
"4266";"5. Optimal adjusted";395;104;291;509;491
"4267";"1. Random";401;105;296;523;477
"4268";"6. Biased  coin";396;102;294;501;500
"4269";"2. Neyman known";425;92;333;433;567
"4270";"3. RSIHR Known";450;71;379;381;619
"4271";"4. Rosenberger known";549;33;516;146;854
"4272";"5. Optimal adjusted";389;107;282;546;454
"4273";"1. Random";413;110;303;496;504
"4274";"6. Biased  coin";421;123;298;501;500
"4275";"2. Neyman known";424;102;322;465;535
"4276";"3. RSIHR Known";451;88;363;372;628
"4277";"4. Rosenberger known";556;30;526;129;871
"4278";"5. Optimal adjusted";400;120;280;541;459
"4279";"1. Random";405;96;309;505;495
"4280";"6. Biased  coin";394;97;297;501;500
"4281";"2. Neyman known";423;87;336;443;557
"4282";"3. RSIHR Known";458;75;383;359;641
"4283";"4. Rosenberger known";552;32;520;142;858
"4284";"5. Optimal adjusted";354;92;262;549;451
"4285";"1. Random";381;100;281;492;508
"4286";"6. Biased  coin";391;98;293;502;500
"4287";"2. Neyman known";411;93;318;442;558
"4288";"3. RSIHR Known";438;71;367;372;628
"4289";"4. Rosenberger known";532;30;502;133;867
"4290";"5. Optimal adjusted";370;106;264;540;460
"4291";"1. Random";392;89;303;488;512
"4292";"6. Biased  coin";384;86;298;501;500
"4293";"2. Neyman known";418;78;340;450;550
"4294";"3. RSIHR Known";463;70;393;368;632
"4295";"4. Rosenberger known";551;32;519;149;851
"4296";"5. Optimal adjusted";397;99;298;524;476
"4297";"1. Random";421;119;302;500;500
"4298";"6. Biased  coin";406;107;299;503;498
"4299";"2. Neyman known";425;110;315;480;520
"4300";"3. RSIHR Known";473;99;374;376;624
"4301";"4. Rosenberger known";538;35;503;166;834
"4302";"5. Optimal adjusted";424;130;294;525;475
"4303";"1. Random";424;93;331;451;549
"4304";"6. Biased  coin";400;92;308;501;500
"4305";"2. Neyman known";414;81;333;450;550
"4306";"3. RSIHR Known";455;77;378;373;627
"4307";"4. Rosenberger known";543;38;505;154;846
"4308";"5. Optimal adjusted";395;108;287;535;465
"4309";"1. Random";408;96;312;498;502
"4310";"6. Biased  coin";398;94;304;500;501
"4311";"2. Neyman known";412;83;329;441;559
"4312";"3. RSIHR Known";459;77;382;371;629
"4313";"4. Rosenberger known";531;28;503;154;846
"4314";"5. Optimal adjusted";384;108;276;542;458
"4315";"1. Random";395;95;300;497;503
"4316";"6. Biased  coin";384;107;277;501;500
"4317";"2. Neyman known";400;87;313;434;566
"4318";"3. RSIHR Known";421;74;347;378;622
"4319";"4. Rosenberger known";516;24;492;138;862
"4320";"5. Optimal adjusted";376;110;266;536;464
"4321";"1. Random";432;106;326;473;527
"4322";"6. Biased  coin";398;103;295;503;497
"4323";"2. Neyman known";423;86;337;462;538
"4324";"3. RSIHR Known";475;80;395;346;654
"4325";"4. Rosenberger known";565;23;542;113;887
"4326";"5. Optimal adjusted";389;111;278;539;461
"4327";"1. Random";392;95;297;494;506
"4328";"6. Biased  coin";412;105;307;500;500
"4329";"2. Neyman known";410;90;320;445;555
"4330";"3. RSIHR Known";450;63;387;353;647
"4331";"4. Rosenberger known";535;19;516;128;872
"4332";"5. Optimal adjusted";351;106;245;555;445
"4333";"1. Random";430;100;330;478;522
"4334";"6. Biased  coin";410;110;300;501;499
"4335";"2. Neyman known";435;96;339;465;535
"4336";"3. RSIHR Known";459;77;382;377;623
"4337";"4. Rosenberger known";558;19;539;139;861
"4338";"5. Optimal adjusted";428;105;323;508;492
"4339";"1. Random";372;98;274;508;492
"4340";"6. Biased  coin";395;102;293;502;500
"4341";"2. Neyman known";408;84;324;441;559
"4342";"3. RSIHR Known";446;64;382;336;664
"4343";"4. Rosenberger known";538;33;505;141;859
"4344";"5. Optimal adjusted";405;107;298;495;505
"4345";"1. Random";401;98;303;489;511
"4346";"6. Biased  coin";402;104;298;499;501
"4347";"2. Neyman known";405;90;315;442;558
"4348";"3. RSIHR Known";431;80;351;389;611
"4349";"4. Rosenberger known";525;25;500;151;849
"4350";"5. Optimal adjusted";367;103;264;527;473
"4351";"1. Random";379;87;292;492;508
"4352";"6. Biased  coin";371;80;291;500;500
"4353";"2. Neyman known";406;91;315;467;533
"4354";"3. RSIHR Known";454;63;391;357;643
"4355";"4. Rosenberger known";527;18;509;138;862
"4356";"5. Optimal adjusted";364;87;277;538;462
"4357";"1. Random";391;106;285;498;502
"4358";"6. Biased  coin";391;108;283;502;500
"4359";"2. Neyman known";395;84;311;453;547
"4360";"3. RSIHR Known";425;72;353;356;644
"4361";"4. Rosenberger known";530;37;493;139;861
"4362";"5. Optimal adjusted";366;105;261;525;475
"4363";"1. Random";413;104;309;511;489
"4364";"6. Biased  coin";400;94;306;500;501
"4365";"2. Neyman known";440;97;343;449;551
"4366";"3. RSIHR Known";467;74;393;352;648
"4367";"4. Rosenberger known";569;29;540;123;877
"4368";"5. Optimal adjusted";388;105;283;550;450
"4369";"1. Random";394;96;298;505;495
"4370";"6. Biased  coin";401;98;303;501;500
"4371";"2. Neyman known";435;101;334;459;541
"4372";"3. RSIHR Known";454;71;383;378;622
"4373";"4. Rosenberger known";553;32;521;155;845
"4374";"5. Optimal adjusted";399;105;294;533;467
"4375";"1. Random";399;90;309;495;505
"4376";"6. Biased  coin";393;97;296;502;501
"4377";"2. Neyman known";420;90;330;443;557
"4378";"3. RSIHR Known";453;77;376;377;623
"4379";"4. Rosenberger known";553;16;537;114;886
"4380";"5. Optimal adjusted";388;92;296;510;490
"4381";"1. Random";375;89;286;496;504
"4382";"6. Biased  coin";388;93;295;499;501
"4383";"2. Neyman known";405;83;322;454;546
"4384";"3. RSIHR Known";434;56;378;356;644
"4385";"4. Rosenberger known";522;25;497;148;852
"4386";"5. Optimal adjusted";367;99;268;541;459
"4387";"1. Random";403;95;308;493;507
"4388";"6. Biased  coin";402;103;299;502;500
"4389";"2. Neyman known";416;104;312;461;539
"4390";"3. RSIHR Known";452;85;367;380;620
"4391";"4. Rosenberger known";543;26;517;141;859
"4392";"5. Optimal adjusted";405;104;301;515;485
"4393";"1. Random";374;90;284;496;504
"4394";"6. Biased  coin";393;109;284;501;500
"4395";"2. Neyman known";438;102;336;426;574
"4396";"3. RSIHR Known";429;87;342;386;614
"4397";"4. Rosenberger known";517;27;490;145;855
"4398";"5. Optimal adjusted";359;101;258;532;468
"4399";"1. Random";429;108;321;476;524
"4400";"6. Biased  coin";416;119;297;499;502
"4401";"2. Neyman known";411;92;319;448;552
"4402";"3. RSIHR Known";463;81;382;352;648
"4403";"4. Rosenberger known";537;27;510;140;860
"4404";"5. Optimal adjusted";380;117;263;536;464
"4405";"1. Random";422;118;304;496;504
"4406";"6. Biased  coin";401;104;297;500;500
"4407";"2. Neyman known";416;89;327;448;552
"4408";"3. RSIHR Known";450;68;382;360;640
"4409";"4. Rosenberger known";555;32;523;144;856
"4410";"5. Optimal adjusted";386;106;280;522;478
"4411";"1. Random";406;95;311;474;526
"4412";"6. Biased  coin";399;106;293;500;500
"4413";"2. Neyman known";414;101;313;474;526
"4414";"3. RSIHR Known";453;89;364;395;605
"4415";"4. Rosenberger known";550;21;529;116;884
"4416";"5. Optimal adjusted";392;109;283;537;463
"4417";"1. Random";418;112;306;490;510
"4418";"6. Biased  coin";420;117;303;500;500
"4419";"2. Neyman known";410;95;315;479;521
"4420";"3. RSIHR Known";463;69;394;332;668
"4421";"4. Rosenberger known";532;40;492;166;834
"4422";"5. Optimal adjusted";399;132;267;545;455
"4423";"1. Random";390;109;281;523;477
"4424";"6. Biased  coin";410;109;301;499;501
"4425";"2. Neyman known";425;94;331;445;555
"4426";"3. RSIHR Known";461;72;389;376;624
"4427";"4. Rosenberger known";555;30;525;139;861
"4428";"5. Optimal adjusted";404;110;294;511;489
"4429";"1. Random";385;92;293;498;502
"4430";"6. Biased  coin";409;96;313;499;501
"4431";"2. Neyman known";415;86;329;441;559
"4432";"3. RSIHR Known";434;70;364;361;639
"4433";"4. Rosenberger known";531;21;510;136;864
"4434";"5. Optimal adjusted";368;95;273;524;476
"4435";"1. Random";363;92;271;518;482
"4436";"6. Biased  coin";389;97;292;500;500
"4437";"2. Neyman known";423;90;333;432;568
"4438";"3. RSIHR Known";426;64;362;382;618
"4439";"4. Rosenberger known";525;20;505;148;852
"4440";"5. Optimal adjusted";370;106;264;556;444
"4441";"1. Random";416;103;313;482;518
"4442";"6. Biased  coin";409;106;303;501;499
"4443";"2. Neyman known";424;94;330;450;550
"4444";"3. RSIHR Known";446;64;382;348;652
"4445";"4. Rosenberger known";554;35;519;145;855
"4446";"5. Optimal adjusted";385;113;272;531;469
"4447";"1. Random";397;105;292;508;492
"4448";"6. Biased  coin";380;89;291;500;500
"4449";"2. Neyman known";420;94;326;464;536
"4450";"3. RSIHR Known";434;80;354;380;620
"4451";"4. Rosenberger known";536;36;500;167;833
"4452";"5. Optimal adjusted";380;96;284;522;478
"4453";"1. Random";422;104;318;488;512
"4454";"6. Biased  coin";402;111;291;501;499
"4455";"2. Neyman known";416;81;335;448;552
"4456";"3. RSIHR Known";458;82;376;379;621
"4457";"4. Rosenberger known";552;27;525;135;865
"4458";"5. Optimal adjusted";401;119;282;537;463
"4459";"1. Random";403;103;300;524;476
"4460";"6. Biased  coin";426;113;313;500;500
"4461";"2. Neyman known";435;88;347;443;557
"4462";"3. RSIHR Known";445;67;378;373;627
"4463";"4. Rosenberger known";558;32;526;138;862
"4464";"5. Optimal adjusted";394;96;298;513;487
"4465";"1. Random";379;99;280;504;496
"4466";"6. Biased  coin";403;114;289;501;500
"4467";"2. Neyman known";394;91;303;463;537
"4468";"3. RSIHR Known";442;80;362;365;635
"4469";"4. Rosenberger known";522;25;497;138;862
"4470";"5. Optimal adjusted";386;128;258;548;452
"4471";"1. Random";376;89;287;494;506
"4472";"6. Biased  coin";387;99;288;499;501
"4473";"2. Neyman known";418;82;336;412;588
"4474";"3. RSIHR Known";429;74;355;370;630
"4475";"4. Rosenberger known";524;31;493;137;863
"4476";"5. Optimal adjusted";371;110;261;557;443
"4477";"1. Random";382;98;284;500;500
"4478";"6. Biased  coin";382;89;293;500;500
"4479";"2. Neyman known";386;83;303;464;536
"4480";"3. RSIHR Known";459;68;391;357;643
"4481";"4. Rosenberger known";519;25;494;139;861
"4482";"5. Optimal adjusted";367;100;267;543;457
"4483";"1. Random";413;109;304;492;508
"4484";"6. Biased  coin";410;112;298;500;500
"4485";"2. Neyman known";431;96;335;434;566
"4486";"3. RSIHR Known";456;73;383;368;632
"4487";"4. Rosenberger known";559;38;521;135;865
"4488";"5. Optimal adjusted";401;120;281;535;465
"4489";"1. Random";370;89;281;508;492
"4490";"6. Biased  coin";382;96;286;501;499
"4491";"2. Neyman known";404;83;321;447;553
"4492";"3. RSIHR Known";458;62;396;334;666
"4493";"4. Rosenberger known";528;25;503;136;864
"4494";"5. Optimal adjusted";362;100;262;556;444
"4495";"1. Random";402;96;306;488;512
"4496";"6. Biased  coin";403;103;300;502;498
"4497";"2. Neyman known";414;93;321;474;526
"4498";"3. RSIHR Known";464;67;397;339;661
"4499";"4. Rosenberger known";525;13;512;130;870
"4500";"5. Optimal adjusted";379;103;276;542;458
"4501";"1. Random";398;80;318;484;516
"4502";"6. Biased  coin";390;93;297;500;500
"4503";"2. Neyman known";424;81;343;424;576
"4504";"3. RSIHR Known";454;71;383;378;622
"4505";"4. Rosenberger known";557;27;530;134;866
"4506";"5. Optimal adjusted";372;93;279;538;462
"4507";"1. Random";392;84;308;480;520
"4508";"6. Biased  coin";380;83;297;500;500
"4509";"2. Neyman known";410;83;327;438;562
"4510";"3. RSIHR Known";460;67;393;345;655
"4511";"4. Rosenberger known";545;26;519;141;859
"4512";"5. Optimal adjusted";379;99;280;540;460
"4513";"1. Random";348;75;273;497;503
"4514";"6. Biased  coin";394;92;302;501;500
"4515";"2. Neyman known";409;91;318;458;542
"4516";"3. RSIHR Known";435;59;376;365;635
"4517";"4. Rosenberger known";527;17;510;122;878
"4518";"5. Optimal adjusted";374;87;287;516;484
"4519";"1. Random";395;101;294;523;477
"4520";"6. Biased  coin";400;101;299;502;499
"4521";"2. Neyman known";416;85;331;437;563
"4522";"3. RSIHR Known";448;61;387;350;650
"4523";"4. Rosenberger known";553;35;518;145;855
"4524";"5. Optimal adjusted";378;102;276;535;465
"4525";"1. Random";399;83;316;479;521
"4526";"6. Biased  coin";401;97;304;500;500
"4527";"2. Neyman known";402;92;310;463;537
"4528";"3. RSIHR Known";455;71;384;353;647
"4529";"4. Rosenberger known";547;29;518;126;874
"4530";"5. Optimal adjusted";378;104;274;559;441
"4531";"1. Random";380;105;275;522;478
"4532";"6. Biased  coin";389;98;291;500;501
"4533";"2. Neyman known";426;97;329;421;579
"4534";"3. RSIHR Known";443;78;365;363;637
"4535";"4. Rosenberger known";535;30;505;135;865
"4536";"5. Optimal adjusted";403;109;294;511;489
"4537";"1. Random";385;95;290;499;501
"4538";"6. Biased  coin";387;96;291;500;500
"4539";"2. Neyman known";395;87;308;463;537
"4540";"3. RSIHR Known";439;63;376;354;646
"4541";"4. Rosenberger known";520;26;494;139;861
"4542";"5. Optimal adjusted";357;98;259;536;464
"4543";"1. Random";409;82;327;456;544
"4544";"6. Biased  coin";383;95;288;500;500
"4545";"2. Neyman known";413;97;316;459;541
"4546";"3. RSIHR Known";437;64;373;373;627
"4547";"4. Rosenberger known";524;29;495;160;840
"4548";"5. Optimal adjusted";393;103;290;528;472
"4549";"1. Random";410;96;314;502;498
"4550";"6. Biased  coin";410;101;309;499;501
"4551";"2. Neyman known";426;90;336;459;541
"4552";"3. RSIHR Known";481;85;396;361;639
"4553";"4. Rosenberger known";569;43;526;156;844
"4554";"5. Optimal adjusted";390;121;269;553;447
"4555";"1. Random";393;81;312;483;517
"4556";"6. Biased  coin";391;89;302;501;501
"4557";"2. Neyman known";438;85;353;440;560
"4558";"3. RSIHR Known";445;58;387;374;626
"4559";"4. Rosenberger known";577;34;543;130;870
"4560";"5. Optimal adjusted";408;113;295;529;471
"4561";"1. Random";389;99;290;483;517
"4562";"6. Biased  coin";410;93;317;501;499
"4563";"2. Neyman known";412;100;312;492;508
"4564";"3. RSIHR Known";458;69;389;347;653
"4565";"4. Rosenberger known";547;26;521;130;870
"4566";"5. Optimal adjusted";366;103;263;544;456
"4567";"1. Random";439;124;315;493;507
"4568";"6. Biased  coin";407;121;286;501;501
"4569";"2. Neyman known";426;103;323;455;545
"4570";"3. RSIHR Known";472;90;382;380;620
"4571";"4. Rosenberger known";544;34;510;149;851
"4572";"5. Optimal adjusted";395;119;276;519;481
"4573";"1. Random";379;105;274;526;474
"4574";"6. Biased  coin";389;94;295;501;500
"4575";"2. Neyman known";391;95;296;452;548
"4576";"3. RSIHR Known";448;81;367;360;640
"4577";"4. Rosenberger known";530;27;503;130;870
"4578";"5. Optimal adjusted";354;103;251;539;461
"4579";"1. Random";404;101;303;482;518
"4580";"6. Biased  coin";393;97;296;502;500
"4581";"2. Neyman known";410;95;315;458;542
"4582";"3. RSIHR Known";425;71;354;379;621
"4583";"4. Rosenberger known";543;33;510;130;870
"4584";"5. Optimal adjusted";380;114;266;553;447
"4585";"1. Random";398;108;290;509;491
"4586";"6. Biased  coin";407;99;308;501;500
"4587";"2. Neyman known";425;88;337;435;565
"4588";"3. RSIHR Known";461;74;387;371;629
"4589";"4. Rosenberger known";546;20;526;133;867
"4590";"5. Optimal adjusted";368;105;263;537;463
"4591";"1. Random";405;110;295;504;496
"4592";"6. Biased  coin";398;102;296;502;499
"4593";"2. Neyman known";393;90;303;455;545
"4594";"3. RSIHR Known";434;72;362;355;645
"4595";"4. Rosenberger known";516;31;485;154;846
"4596";"5. Optimal adjusted";376;111;265;534;466
"4597";"1. Random";422;98;324;474;526
"4598";"6. Biased  coin";388;107;281;500;502
"4599";"2. Neyman known";423;91;332;448;552
"4600";"3. RSIHR Known";450;76;374;384;616
"4601";"4. Rosenberger known";536;26;510;137;863
"4602";"5. Optimal adjusted";378;106;272;536;464
"4603";"1. Random";414;108;306;493;507
"4604";"6. Biased  coin";429;124;305;501;499
"4605";"2. Neyman known";442;115;327;445;555
"4606";"3. RSIHR Known";471;83;388;361;639
"4607";"4. Rosenberger known";529;29;500;159;841
"4608";"5. Optimal adjusted";374;111;263;548;452
"4609";"1. Random";403;97;306;492;508
"4610";"6. Biased  coin";429;113;316;502;499
"4611";"2. Neyman known";424;99;325;439;561
"4612";"3. RSIHR Known";424;72;352;389;611
"4613";"4. Rosenberger known";561;34;527;139;861
"4614";"5. Optimal adjusted";411;119;292;529;471
"4615";"1. Random";388;111;277;524;476
"4616";"6. Biased  coin";390;108;282;502;498
"4617";"2. Neyman known";413;103;310;467;533
"4618";"3. RSIHR Known";444;81;363;395;605
"4619";"4. Rosenberger known";537;28;509;133;867
"4620";"5. Optimal adjusted";421;125;296;534;466
"4621";"1. Random";370;93;277;501;499
"4622";"6. Biased  coin";377;101;276;500;500
"4623";"2. Neyman known";403;99;304;464;536
"4624";"3. RSIHR Known";438;82;356;375;625
"4625";"4. Rosenberger known";520;23;497;132;868
"4626";"5. Optimal adjusted";379;109;270;523;477
"4627";"1. Random";405;115;290;500;500
"4628";"6. Biased  coin";396;108;288;499;501
"4629";"2. Neyman known";425;93;332;419;581
"4630";"3. RSIHR Known";440;83;357;399;601
"4631";"4. Rosenberger known";532;34;498;134;866
"4632";"5. Optimal adjusted";388;130;258;564;436
"4633";"1. Random";383;96;287;493;507
"4634";"6. Biased  coin";406;102;304;501;500
"4635";"2. Neyman known";405;82;323;460;540
"4636";"3. RSIHR Known";400;63;337;376;624
"4637";"4. Rosenberger known";538;31;507;129;871
"4638";"5. Optimal adjusted";377;114;263;542;458
"4639";"1. Random";409;128;281;526;474
"4640";"6. Biased  coin";393;96;297;501;499
"4641";"2. Neyman known";420;98;322;450;550
"4642";"3. RSIHR Known";454;78;376;359;641
"4643";"4. Rosenberger known";510;32;478;159;841
"4644";"5. Optimal adjusted";392;123;269;539;461
"4645";"1. Random";398;93;305;506;494
"4646";"6. Biased  coin";407;101;306;504;498
"4647";"2. Neyman known";423;88;335;444;556
"4648";"3. RSIHR Known";466;63;403;337;663
"4649";"4. Rosenberger known";534;28;506;157;843
"4650";"5. Optimal adjusted";387;91;296;528;472
"4651";"1. Random";393;98;295;503;497
"4652";"6. Biased  coin";399;104;295;500;500
"4653";"2. Neyman known";427;100;327;472;528
"4654";"3. RSIHR Known";450;75;375;372;628
"4655";"4. Rosenberger known";540;30;510;149;851
"4656";"5. Optimal adjusted";399;120;279;537;463
"4657";"1. Random";373;99;274;536;464
"4658";"6. Biased  coin";413;103;310;500;500
"4659";"2. Neyman known";417;80;337;440;560
"4660";"3. RSIHR Known";435;78;357;394;606
"4661";"4. Rosenberger known";538;41;497;161;839
"4662";"5. Optimal adjusted";395;105;290;519;481
"4663";"1. Random";413;113;300;497;503
"4664";"6. Biased  coin";395;92;303;502;500
"4665";"2. Neyman known";415;78;337;447;553
"4666";"3. RSIHR Known";452;79;373;387;613
"4667";"4. Rosenberger known";551;33;518;137;863
"4668";"5. Optimal adjusted";378;109;269;531;469
"4669";"1. Random";418;103;315;495;505
"4670";"6. Biased  coin";402;118;284;500;500
"4671";"2. Neyman known";425;82;343;414;586
"4672";"3. RSIHR Known";457;83;374;371;629
"4673";"4. Rosenberger known";537;36;501;146;854
"4674";"5. Optimal adjusted";387;124;263;546;454
"4675";"1. Random";395;89;306;480;520
"4676";"6. Biased  coin";396;97;299;501;500
"4677";"2. Neyman known";432;90;342;437;563
"4678";"3. RSIHR Known";450;59;391;344;656
"4679";"4. Rosenberger known";537;25;512;137;863
"4680";"5. Optimal adjusted";379;97;282;533;467
"4681";"1. Random";374;98;276;503;497
"4682";"6. Biased  coin";371;78;293;499;501
"4683";"2. Neyman known";390;72;318;449;551
"4684";"3. RSIHR Known";449;75;374;378;622
"4685";"4. Rosenberger known";536;27;509;147;853
"4686";"5. Optimal adjusted";359;96;263;537;463
"4687";"1. Random";400;104;296;492;508
"4688";"6. Biased  coin";416;114;302;502;499
"4689";"2. Neyman known";427;97;330;456;544
"4690";"3. RSIHR Known";472;78;394;363;637
"4691";"4. Rosenberger known";529;31;498;157;843
"4692";"5. Optimal adjusted";379;114;265;555;445
"4693";"1. Random";383;94;289;495;505
"4694";"6. Biased  coin";392;94;298;500;501
"4695";"2. Neyman known";418;100;318;472;528
"4696";"3. RSIHR Known";456;65;391;345;655
"4697";"4. Rosenberger known";530;32;498;161;839
"4698";"5. Optimal adjusted";410;116;294;525;475
"4699";"1. Random";370;94;276;506;494
"4700";"6. Biased  coin";394;114;280;502;500
"4701";"2. Neyman known";388;82;306;434;566
"4702";"3. RSIHR Known";448;79;369;350;650
"4703";"4. Rosenberger known";513;28;485;146;854
"4704";"5. Optimal adjusted";361;95;266;541;459
"4705";"1. Random";427;124;303;511;489
"4706";"6. Biased  coin";431;119;312;502;500
"4707";"2. Neyman known";436;118;318;474;526
"4708";"3. RSIHR Known";494;88;406;338;662
"4709";"4. Rosenberger known";538;41;497;169;831
"4710";"5. Optimal adjusted";415;133;282;528;472
"4711";"1. Random";375;98;277;508;492
"4712";"6. Biased  coin";380;109;271;502;499
"4713";"2. Neyman known";392;85;307;455;545
"4714";"3. RSIHR Known";432;78;354;377;623
"4715";"4. Rosenberger known";519;24;495;133;867
"4716";"5. Optimal adjusted";354;107;247;556;444
"4717";"1. Random";374;99;275;494;506
"4718";"6. Biased  coin";380;100;280;504;499
"4719";"2. Neyman known";401;98;303;452;548
"4720";"3. RSIHR Known";438;81;357;363;637
"4721";"4. Rosenberger known";514;37;477;153;847
"4722";"5. Optimal adjusted";378;116;262;539;461
"4723";"1. Random";379;91;288;500;500
"4724";"6. Biased  coin";379;82;297;501;500
"4725";"2. Neyman known";414;73;341;432;568
"4726";"3. RSIHR Known";436;70;366;392;608
"4727";"4. Rosenberger known";527;18;509;126;874
"4728";"5. Optimal adjusted";347;86;261;543;457
"4729";"1. Random";393;104;289;505;495
"4730";"6. Biased  coin";398;99;299;503;500
"4731";"2. Neyman known";439;96;343;456;544
"4732";"3. RSIHR Known";467;72;395;350;650
"4733";"4. Rosenberger known";528;28;500;160;840
"4734";"5. Optimal adjusted";385;113;272;538;462
"4735";"1. Random";396;96;300;490;510
"4736";"6. Biased  coin";394;104;290;500;500
"4737";"2. Neyman known";407;91;316;449;551
"4738";"3. RSIHR Known";425;74;351;365;635
"4739";"4. Rosenberger known";521;23;498;152;848
"4740";"5. Optimal adjusted";383;117;266;547;453
"4741";"1. Random";422;119;303;508;492
"4742";"6. Biased  coin";429;120;309;502;499
"4743";"2. Neyman known";417;96;321;468;532
"4744";"3. RSIHR Known";483;83;400;346;654
"4745";"4. Rosenberger known";549;31;518;152;848
"4746";"5. Optimal adjusted";399;110;289;537;463
"4747";"1. Random";416;107;309;494;506
"4748";"6. Biased  coin";425;124;301;500;500
"4749";"2. Neyman known";435;90;345;432;568
"4750";"3. RSIHR Known";489;90;399;354;646
"4751";"4. Rosenberger known";541;28;513;154;846
"4752";"5. Optimal adjusted";398;108;290;508;492
"4753";"1. Random";430;107;323;472;528
"4754";"6. Biased  coin";404;93;311;499;502
"4755";"2. Neyman known";408;80;328;431;569
"4756";"3. RSIHR Known";457;79;378;376;624
"4757";"4. Rosenberger known";539;33;506;156;844
"4758";"5. Optimal adjusted";378;109;269;550;450
"4759";"1. Random";394;90;304;487;513
"4760";"6. Biased  coin";388;96;292;500;500
"4761";"2. Neyman known";409;84;325;434;566
"4762";"3. RSIHR Known";451;71;380;356;644
"4763";"4. Rosenberger known";523;24;499;144;856
"4764";"5. Optimal adjusted";355;92;263;529;471
"4765";"1. Random";385;93;292;533;467
"4766";"6. Biased  coin";385;87;298;501;499
"4767";"2. Neyman known";417;87;330;459;541
"4768";"3. RSIHR Known";441;59;382;366;634
"4769";"4. Rosenberger known";536;28;508;158;842
"4770";"5. Optimal adjusted";370;92;278;541;459
"4771";"1. Random";382;99;283;517;483
"4772";"6. Biased  coin";397;103;294;502;500
"4773";"2. Neyman known";402;77;325;426;574
"4774";"3. RSIHR Known";454;68;386;338;662
"4775";"4. Rosenberger known";519;30;489;165;835
"4776";"5. Optimal adjusted";370;107;263;552;448
"4777";"1. Random";376;84;292;506;494
"4778";"6. Biased  coin";379;96;283;500;500
"4779";"2. Neyman known";414;80;334;442;558
"4780";"3. RSIHR Known";418;62;356;386;614
"4781";"4. Rosenberger known";525;25;500;151;849
"4782";"5. Optimal adjusted";379;114;265;560;440
"4783";"1. Random";413;113;300;486;514
"4784";"6. Biased  coin";422;120;302;500;500
"4785";"2. Neyman known";434;104;330;440;560
"4786";"3. RSIHR Known";445;84;361;383;617
"4787";"4. Rosenberger known";555;50;505;148;852
"4788";"5. Optimal adjusted";376;125;251;550;450
"4789";"1. Random";406;96;310;474;526
"4790";"6. Biased  coin";389;91;298;502;499
"4791";"2. Neyman known";392;85;307;467;533
"4792";"3. RSIHR Known";457;78;379;378;622
"4793";"4. Rosenberger known";537;33;504;151;849
"4794";"5. Optimal adjusted";386;99;287;508;492
"4795";"1. Random";374;97;277;515;485
"4796";"6. Biased  coin";400;98;302;503;500
"4797";"2. Neyman known";412;81;331;435;565
"4798";"3. RSIHR Known";439;65;374;379;621
"4799";"4. Rosenberger known";552;34;518;134;866
"4800";"5. Optimal adjusted";358;98;260;532;468
"4801";"1. Random";424;120;304;492;508
"4802";"6. Biased  coin";418;114;304;500;500
"4803";"2. Neyman known";449;108;341;446;554
"4804";"3. RSIHR Known";464;75;389;368;632
"4805";"4. Rosenberger known";550;33;517;146;854
"4806";"5. Optimal adjusted";402;105;297;522;478
"4807";"1. Random";383;98;285;523;477
"4808";"6. Biased  coin";394;100;294;500;500
"4809";"2. Neyman known";419;86;333;449;551
"4810";"3. RSIHR Known";455;63;392;351;649
"4811";"4. Rosenberger known";520;17;503;146;854
"4812";"5. Optimal adjusted";363;104;259;565;435
"4813";"1. Random";389;85;304;487;513
"4814";"6. Biased  coin";379;86;293;502;498
"4815";"2. Neyman known";395;77;318;450;550
"4816";"3. RSIHR Known";449;63;386;348;652
"4817";"4. Rosenberger known";540;26;514;135;865
"4818";"5. Optimal adjusted";360;98;262;533;467
"4819";"1. Random";415;112;303;507;493
"4820";"6. Biased  coin";409;98;311;503;499
"4821";"2. Neyman known";427;102;325;468;532
"4822";"3. RSIHR Known";441;57;384;357;643
"4823";"4. Rosenberger known";554;33;521;143;857
"4824";"5. Optimal adjusted";394;108;286;523;477
"4825";"1. Random";392;93;299;484;516
"4826";"6. Biased  coin";398;98;300;505;500
"4827";"2. Neyman known";422;83;339;439;561
"4828";"3. RSIHR Known";438;78;360;391;609
"4829";"4. Rosenberger known";529;29;500;160;840
"4830";"5. Optimal adjusted";363;103;260;552;448
"4831";"1. Random";402;99;303;497;503
"4832";"6. Biased  coin";380;94;286;500;500
"4833";"2. Neyman known";399;77;322;441;559
"4834";"3. RSIHR Known";457;77;380;369;631
"4835";"4. Rosenberger known";533;27;506;133;867
"4836";"5. Optimal adjusted";380;112;268;526;474
"4837";"1. Random";427;109;318;489;511
"4838";"6. Biased  coin";408;107;301;501;499
"4839";"2. Neyman known";431;96;335;431;569
"4840";"3. RSIHR Known";468;86;382;371;629
"4841";"4. Rosenberger known";536;24;512;134;866
"4842";"5. Optimal adjusted";395;122;273;537;463
"4843";"1. Random";349;90;259;533;467
"4844";"6. Biased  coin";392;95;297;500;500
"4845";"2. Neyman known";406;90;316;477;523
"4846";"3. RSIHR Known";457;77;380;370;630
"4847";"4. Rosenberger known";546;28;518;140;860
"4848";"5. Optimal adjusted";420;115;305;507;493
"4849";"1. Random";371;99;272;524;476
"4850";"6. Biased  coin";385;104;281;502;498
"4851";"2. Neyman known";419;95;324;457;543
"4852";"3. RSIHR Known";450;67;383;345;655
"4853";"4. Rosenberger known";534;27;507;128;872
"4854";"5. Optimal adjusted";389;105;284;520;480
"4855";"1. Random";396;99;297;498;502
"4856";"6. Biased  coin";398;97;301;501;499
"4857";"2. Neyman known";436;108;328;469;531
"4858";"3. RSIHR Known";449;75;374;371;629
"4859";"4. Rosenberger known";541;30;511;149;851
"4860";"5. Optimal adjusted";386;113;273;534;466
"4861";"1. Random";403;110;293;500;500
"4862";"6. Biased  coin";377;102;275;501;500
"4863";"2. Neyman known";436;105;331;447;553
"4864";"3. RSIHR Known";467;75;392;344;656
"4865";"4. Rosenberger known";535;40;495;145;855
"4866";"5. Optimal adjusted";409;114;295;515;485
"4867";"1. Random";387;115;272;517;483
"4868";"6. Biased  coin";390;109;281;504;498
"4869";"2. Neyman known";418;118;300;490;510
"4870";"3. RSIHR Known";476;89;387;347;653
"4871";"4. Rosenberger known";550;42;508;155;845
"4872";"5. Optimal adjusted";408;128;280;527;473
"4873";"1. Random";395;96;299;517;483
"4874";"6. Biased  coin";394;97;297;501;500
"4875";"2. Neyman known";400;77;323;449;551
"4876";"3. RSIHR Known";451;74;377;382;618
"4877";"4. Rosenberger known";546;27;519;144;856
"4878";"5. Optimal adjusted";364;94;270;552;448
"4879";"1. Random";410;88;322;456;544
"4880";"6. Biased  coin";393;99;294;501;499
"4881";"2. Neyman known";402;80;322;440;560
"4882";"3. RSIHR Known";439;72;367;366;634
"4883";"4. Rosenberger known";531;40;491;149;851
"4884";"5. Optimal adjusted";362;92;270;536;464
"4885";"1. Random";394;85;309;489;511
"4886";"6. Biased  coin";373;89;284;503;500
"4887";"2. Neyman known";414;79;335;427;573
"4888";"3. RSIHR Known";431;68;363;363;637
"4889";"4. Rosenberger known";516;29;487;156;844
"4890";"5. Optimal adjusted";392;105;287;512;488
"4891";"1. Random";393;104;289;505;495
"4892";"6. Biased  coin";395;92;303;501;500
"4893";"2. Neyman known";421;101;320;456;544
"4894";"3. RSIHR Known";451;75;376;368;632
"4895";"4. Rosenberger known";524;28;496;152;848
"4896";"5. Optimal adjusted";377;99;278;514;486
"4897";"1. Random";406;88;318;480;520
"4898";"6. Biased  coin";400;94;306;502;500
"4899";"2. Neyman known";425;80;345;447;553
"4900";"3. RSIHR Known";447;71;376;383;617
"4901";"4. Rosenberger known";565;30;535;131;869
"4902";"5. Optimal adjusted";404;106;298;535;465
"4903";"1. Random";420;101;319;492;508
"4904";"6. Biased  coin";417;114;303;501;500
"4905";"2. Neyman known";442;89;353;438;562
"4906";"3. RSIHR Known";451;91;360;403;597
"4907";"4. Rosenberger known";556;34;522;146;854
"4908";"5. Optimal adjusted";371;107;264;549;451
"4909";"1. Random";382;103;279;509;491
"4910";"6. Biased  coin";375;97;278;500;500
"4911";"2. Neyman known";391;79;312;446;554
"4912";"3. RSIHR Known";428;70;358;375;625
"4913";"4. Rosenberger known";521;27;494;129;871
"4914";"5. Optimal adjusted";370;106;264;541;459
"4915";"1. Random";387;98;289;502;498
"4916";"6. Biased  coin";397;99;298;499;502
"4917";"2. Neyman known";405;83;322;442;558
"4918";"3. RSIHR Known";456;71;385;352;648
"4919";"4. Rosenberger known";520;43;477;175;825
"4920";"5. Optimal adjusted";377;106;271;536;464
"4921";"1. Random";408;112;296;506;494
"4922";"6. Biased  coin";397;101;296;499;501
"4923";"2. Neyman known";413;90;323;440;560
"4924";"3. RSIHR Known";435;79;356;391;609
"4925";"4. Rosenberger known";529;28;501;140;860
"4926";"5. Optimal adjusted";371;120;251;563;437
"4927";"1. Random";407;92;315;492;508
"4928";"6. Biased  coin";390;99;291;500;500
"4929";"2. Neyman known";402;88;314;460;540
"4930";"3. RSIHR Known";450;77;373;359;641
"4931";"4. Rosenberger known";530;18;512;148;852
"4932";"5. Optimal adjusted";392;108;284;533;467
"4933";"1. Random";409;99;310;484;516
"4934";"6. Biased  coin";405;99;306;499;501
"4935";"2. Neyman known";419;84;335;435;565
"4936";"3. RSIHR Known";448;69;379;350;650
"4937";"4. Rosenberger known";536;23;513;132;868
"4938";"5. Optimal adjusted";363;118;245;562;438
"4939";"1. Random";404;89;315;495;505
"4940";"6. Biased  coin";398;92;306;501;501
"4941";"2. Neyman known";424;80;344;442;558
"4942";"3. RSIHR Known";466;69;397;356;644
"4943";"4. Rosenberger known";563;30;533;140;860
"4944";"5. Optimal adjusted";377;100;277;560;440
"4945";"1. Random";387;90;297;498;502
"4946";"6. Biased  coin";363;84;279;504;499
"4947";"2. Neyman known";427;97;330;454;546
"4948";"3. RSIHR Known";428;69;359;383;617
"4949";"4. Rosenberger known";541;25;516;137;863
"4950";"5. Optimal adjusted";387;107;280;539;461
"4951";"1. Random";409;106;303;504;496
"4952";"6. Biased  coin";374;86;288;505;499
"4953";"2. Neyman known";405;94;311;470;530
"4954";"3. RSIHR Known";426;71;355;379;621
"4955";"4. Rosenberger known";520;25;495;143;857
"4956";"5. Optimal adjusted";357;98;259;544;456
"4957";"1. Random";403;108;295;499;501
"4958";"6. Biased  coin";417;121;296;500;500
"4959";"2. Neyman known";420;107;313;455;545
"4960";"3. RSIHR Known";434;77;357;367;633
"4961";"4. Rosenberger known";528;33;495;136;864
"4962";"5. Optimal adjusted";386;114;272;528;472
"4963";"1. Random";401;100;301;496;504
"4964";"6. Biased  coin";411;100;311;502;498
"4965";"2. Neyman known";436;95;341;435;565
"4966";"3. RSIHR Known";440;69;371;386;614
"4967";"4. Rosenberger known";530;18;512;144;856
"4968";"5. Optimal adjusted";377;113;264;564;436
"4969";"1. Random";400;96;304;482;518
"4970";"6. Biased  coin";414;109;305;502;499
"4971";"2. Neyman known";412;93;319;453;547
"4972";"3. RSIHR Known";427;63;364;361;639
"4973";"4. Rosenberger known";533;18;515;133;867
"4974";"5. Optimal adjusted";365;91;274;537;463
"4975";"1. Random";433;102;331;487;513
"4976";"6. Biased  coin";434;116;318;499;501
"4977";"2. Neyman known";449;97;352;438;562
"4978";"3. RSIHR Known";481;74;407;357;643
"4979";"4. Rosenberger known";567;32;535;148;852
"4980";"5. Optimal adjusted";442;127;315;515;485
"4981";"1. Random";393;111;282;528;472
"4982";"6. Biased  coin";425;121;304;501;500
"4983";"2. Neyman known";406;104;302;470;530
"4984";"3. RSIHR Known";464;87;377;385;615
"4985";"4. Rosenberger known";525;35;490;176;824
"4986";"5. Optimal adjusted";397;107;290;528;472
"4987";"1. Random";385;95;290;493;507
"4988";"6. Biased  coin";400;102;298;502;499
"4989";"2. Neyman known";382;80;302;482;518
"4990";"3. RSIHR Known";414;62;352;379;621
"4991";"4. Rosenberger known";523;20;503;146;854
"4992";"5. Optimal adjusted";374;98;276;511;489
"4993";"1. Random";387;90;297;487;513
"4994";"6. Biased  coin";376;88;288;502;499
"4995";"2. Neyman known";395;85;310;452;548
"4996";"3. RSIHR Known";435;73;362;369;631
"4997";"4. Rosenberger known";531;31;500;152;848
"4998";"5. Optimal adjusted";396;102;294;510;490
"4999";"1. Random";387;83;304;479;521
"5000";"6. Biased  coin";412;118;294;501;499
"5001";"2. Neyman known";423;91;332;429;571
"5002";"3. RSIHR Known";464;87;377;381;619
"5003";"4. Rosenberger known";538;30;508;133;867
"5004";"5. Optimal adjusted";383;125;258;546;454
"5005";"1. Random";414;102;312;481;519
"5006";"6. Biased  coin";395;108;287;501;500
"5007";"2. Neyman known";419;93;326;453;547
"5008";"3. RSIHR Known";475;77;398;359;641
"5009";"4. Rosenberger known";562;34;528;138;862
"5010";"5. Optimal adjusted";396;118;278;545;455
"5011";"1. Random";404;113;291;510;490
"5012";"6. Biased  coin";417;104;313;501;499
"5013";"2. Neyman known";435;100;335;439;561
"5014";"3. RSIHR Known";464;68;396;333;667
"5015";"4. Rosenberger known";553;34;519;150;850
"5016";"5. Optimal adjusted";410;130;280;549;451
"5017";"1. Random";386;111;275;519;481
"5018";"6. Biased  coin";368;94;274;501;500
"5019";"2. Neyman known";415;96;319;445;555
"5020";"3. RSIHR Known";450;74;376;337;663
"5021";"4. Rosenberger known";517;33;484;148;852
"5022";"5. Optimal adjusted";383;117;266;529;471
"5023";"1. Random";405;109;296;468;532
"5024";"6. Biased  coin";390;108;282;498;502
"5025";"2. Neyman known";390;89;301;452;548
"5026";"3. RSIHR Known";449;77;372;352;648
"5027";"4. Rosenberger known";513;32;481;158;842
"5028";"5. Optimal adjusted";376;116;260;553;447
"5029";"1. Random";420;103;317;460;540
"5030";"6. Biased  coin";401;102;299;500;500
"5031";"2. Neyman known";432;82;350;430;570
"5032";"3. RSIHR Known";462;78;384;355;645
"5033";"4. Rosenberger known";547;34;513;146;854
"5034";"5. Optimal adjusted";376;110;266;530;470
"5035";"1. Random";364;96;268;530;470
"5036";"6. Biased  coin";382;94;288;500;501
"5037";"2. Neyman known";409;97;312;458;542
"5038";"3. RSIHR Known";435;66;369;333;667
"5039";"4. Rosenberger known";545;36;509;140;860
"5040";"5. Optimal adjusted";373;105;268;541;459
"5041";"1. Random";371;93;278;510;490
"5042";"6. Biased  coin";408;103;305;501;500
"5043";"2. Neyman known";396;86;310;472;528
"5044";"3. RSIHR Known";427;64;363;361;639
"5045";"4. Rosenberger known";521;26;495;137;863
"5046";"5. Optimal adjusted";349;95;254;520;480
"5047";"1. Random";407;89;318;484;516
"5048";"6. Biased  coin";367;91;276;501;500
"5049";"2. Neyman known";389;74;315;451;549
"5050";"3. RSIHR Known";444;76;368;373;627
"5051";"4. Rosenberger known";525;21;504;138;862
"5052";"5. Optimal adjusted";390;107;283;523;477
"5053";"1. Random";394;111;283;534;466
"5054";"6. Biased  coin";391;100;291;500;500
"5055";"2. Neyman known";409;97;312;479;521
"5056";"3. RSIHR Known";430;84;346;389;611
"5057";"4. Rosenberger known";519;34;485;151;849
"5058";"5. Optimal adjusted";369;101;268;532;468
"5059";"1. Random";406;95;311;498;502
"5060";"6. Biased  coin";397;102;295;501;500
"5061";"2. Neyman known";423;91;332;452;548
"5062";"3. RSIHR Known";458;63;395;368;632
"5063";"4. Rosenberger known";559;28;531;129;871
"5064";"5. Optimal adjusted";401;122;279;554;446
"5065";"1. Random";408;101;307;502;498
"5066";"6. Biased  coin";384;89;295;503;499
"5067";"2. Neyman known";425;78;347;429;571
"5068";"3. RSIHR Known";450;75;375;374;626
"5069";"4. Rosenberger known";542;24;518;143;857
"5070";"5. Optimal adjusted";392;117;275;550;450
"5071";"1. Random";396;111;285;506;494
"5072";"6. Biased  coin";418;109;309;502;499
"5073";"2. Neyman known";428;93;335;439;561
"5074";"3. RSIHR Known";434;72;362;368;632
"5075";"4. Rosenberger known";520;26;494;154;846
"5076";"5. Optimal adjusted";390;101;289;518;482
"5077";"1. Random";424;98;326;478;522
"5078";"6. Biased  coin";406;98;308;499;502
"5079";"2. Neyman known";422;88;334;462;538
"5080";"3. RSIHR Known";448;59;389;358;642
"5081";"4. Rosenberger known";567;30;537;146;854
"5082";"5. Optimal adjusted";400;99;301;497;503
"5083";"1. Random";415;89;326;503;497
"5084";"6. Biased  coin";399;101;298;502;499
"5085";"2. Neyman known";408;83;325;453;547
"5086";"3. RSIHR Known";434;67;367;375;625
"5087";"4. Rosenberger known";525;28;497;148;852
"5088";"5. Optimal adjusted";372;101;271;542;458
"5089";"1. Random";382;102;280;541;459
"5090";"6. Biased  coin";394;94;300;500;500
"5091";"2. Neyman known";421;84;337;440;560
"5092";"3. RSIHR Known";436;69;367;360;640
"5093";"4. Rosenberger known";547;32;515;129;871
"5094";"5. Optimal adjusted";403;115;288;525;475
"5095";"1. Random";407;110;297;504;496
"5096";"6. Biased  coin";410;119;291;501;500
"5097";"2. Neyman known";404;105;299;463;537
"5098";"3. RSIHR Known";444;71;373;359;641
"5099";"4. Rosenberger known";536;29;507;133;867
"5100";"5. Optimal adjusted";393;118;275;528;472
"5101";"1. Random";412;108;304;504;496
"5102";"6. Biased  coin";401;101;300;503;499
"5103";"2. Neyman known";418;87;331;445;555
"5104";"3. RSIHR Known";464;84;380;388;612
"5105";"4. Rosenberger known";536;27;509;155;845
"5106";"5. Optimal adjusted";363;116;247;587;413
"5107";"1. Random";401;102;299;490;510
"5108";"6. Biased  coin";376;97;279;500;500
"5109";"2. Neyman known";412;79;333;420;580
"5110";"3. RSIHR Known";421;70;351;370;630
"5111";"4. Rosenberger known";540;37;503;138;862
"5112";"5. Optimal adjusted";375;95;280;521;479
"5113";"1. Random";377;95;282;513;487
"5114";"6. Biased  coin";399;106;293;501;499
"5115";"2. Neyman known";413;86;327;443;557
"5116";"3. RSIHR Known";457;67;390;327;673
"5117";"4. Rosenberger known";529;18;511;132;868
"5118";"5. Optimal adjusted";378;99;279;519;481
"5119";"1. Random";401;103;298;501;499
"5120";"6. Biased  coin";402;104;298;500;500
"5121";"2. Neyman known";441;98;343;445;555
"5122";"3. RSIHR Known";458;68;390;373;627
"5123";"4. Rosenberger known";563;29;534;130;870
"5124";"5. Optimal adjusted";374;90;284;522;478
"5125";"1. Random";392;95;297;502;498
"5126";"6. Biased  coin";416;102;314;500;500
"5127";"2. Neyman known";398;80;318;456;544
"5128";"3. RSIHR Known";447;75;372;380;620
"5129";"4. Rosenberger known";531;24;507;149;851
"5130";"5. Optimal adjusted";375;106;269;546;454
"5131";"1. Random";418;107;311;497;503
"5132";"6. Biased  coin";428;122;306;500;500
"5133";"2. Neyman known";442;91;351;429;571
"5134";"3. RSIHR Known";475;78;397;373;627
"5135";"4. Rosenberger known";549;27;522;144;856
"5136";"5. Optimal adjusted";408;102;306;515;485
"5137";"1. Random";380;110;270;505;495
"5138";"6. Biased  coin";408;119;289;501;500
"5139";"2. Neyman known";410;89;321;432;568
"5140";"3. RSIHR Known";420;72;348;369;631
"5141";"4. Rosenberger known";516;27;489;130;870
"5142";"5. Optimal adjusted";379;119;260;545;455
"5143";"1. Random";388;101;287;516;484
"5144";"6. Biased  coin";382;80;302;501;500
"5145";"2. Neyman known";411;86;325;480;520
"5146";"3. RSIHR Known";445;56;389;360;640
"5147";"4. Rosenberger known";569;34;535;128;872
"5148";"5. Optimal adjusted";401;107;294;522;478
"5149";"1. Random";377;114;263;545;455
"5150";"6. Biased  coin";389;100;289;500;500
"5151";"2. Neyman known";414;88;326;438;562
"5152";"3. RSIHR Known";439;84;355;391;609
"5153";"4. Rosenberger known";533;36;497;149;851
"5154";"5. Optimal adjusted";378;92;286;499;501
"5155";"1. Random";377;92;285;500;500
"5156";"6. Biased  coin";366;85;281;502;500
"5157";"2. Neyman known";388;80;308;456;544
"5158";"3. RSIHR Known";433;58;375;342;658
"5159";"4. Rosenberger known";511;17;494;155;845
"5160";"5. Optimal adjusted";356;104;252;561;439
"5161";"1. Random";411;93;318;496;504
"5162";"6. Biased  coin";409;105;304;503;500
"5163";"2. Neyman known";429;78;351;424;576
"5164";"3. RSIHR Known";443;58;385;375;625
"5165";"4. Rosenberger known";563;33;530;135;865
"5166";"5. Optimal adjusted";375;99;276;558;442
"5167";"1. Random";426;96;330;458;542
"5168";"6. Biased  coin";395;101;294;500;500
"5169";"2. Neyman known";409;84;325;454;546
"5170";"3. RSIHR Known";431;76;355;389;611
"5171";"4. Rosenberger known";534;31;503;155;845
"5172";"5. Optimal adjusted";380;118;262;555;445
"5173";"1. Random";398;92;306;489;511
"5174";"6. Biased  coin";406;104;302;496;504
"5175";"2. Neyman known";421;85;336;448;552
"5176";"3. RSIHR Known";438;78;360;384;616
"5177";"4. Rosenberger known";557;32;525;132;868
"5178";"5. Optimal adjusted";388;113;275;542;458
"5179";"1. Random";420;109;311;505;495
"5180";"6. Biased  coin";421;104;317;498;502
"5181";"2. Neyman known";422;88;334;435;565
"5182";"3. RSIHR Known";461;74;387;377;623
"5183";"4. Rosenberger known";548;23;525;132;868
"5184";"5. Optimal adjusted";399;107;292;525;475
"5185";"1. Random";425;106;319;475;525
"5186";"6. Biased  coin";401;106;295;506;500
"5187";"2. Neyman known";416;88;328;451;549
"5188";"3. RSIHR Known";417;68;349;398;602
"5189";"4. Rosenberger known";547;37;510;152;848
"5190";"5. Optimal adjusted";376;105;271;531;469
"5191";"1. Random";393;94;299;510;490
"5192";"6. Biased  coin";406;104;302;501;499
"5193";"2. Neyman known";420;85;335;430;570
"5194";"3. RSIHR Known";449;81;368;373;627
"5195";"4. Rosenberger known";527;27;500;135;865
"5196";"5. Optimal adjusted";385;115;270;552;448
"5197";"1. Random";426;107;319;486;514
"5198";"6. Biased  coin";389;102;287;500;500
"5199";"2. Neyman known";425;92;333;431;569
"5200";"3. RSIHR Known";470;82;388;358;642
"5201";"4. Rosenberger known";528;27;501;144;856
"5202";"5. Optimal adjusted";403;121;282;530;470
"5203";"1. Random";409;115;294;505;495
"5204";"6. Biased  coin";383;107;276;502;501
"5205";"2. Neyman known";434;89;345;427;573
"5206";"3. RSIHR Known";458;70;388;363;637
"5207";"4. Rosenberger known";544;34;510;140;860
"5208";"5. Optimal adjusted";374;110;264;530;470
"5209";"1. Random";397;91;306;487;513
"5210";"6. Biased  coin";392;93;299;500;500
"5211";"2. Neyman known";424;87;337;447;553
"5212";"3. RSIHR Known";432;64;368;392;608
"5213";"4. Rosenberger known";552;32;520;147;853
"5214";"5. Optimal adjusted";373;89;284;517;483
"5215";"1. Random";408;100;308;489;511
"5216";"6. Biased  coin";405;106;299;501;499
"5217";"2. Neyman known";425;94;331;456;544
"5218";"3. RSIHR Known";469;72;397;353;647
"5219";"4. Rosenberger known";546;34;512;141;859
"5220";"5. Optimal adjusted";372;96;276;513;487
"5221";"1. Random";359;80;279;505;495
"5222";"6. Biased  coin";368;77;291;499;501
"5223";"2. Neyman known";403;77;326;457;543
"5224";"3. RSIHR Known";409;66;343;387;613
"5225";"4. Rosenberger known";519;30;489;154;846
"5226";"5. Optimal adjusted";352;104;248;552;448
"5227";"1. Random";420;100;320;479;521
"5228";"6. Biased  coin";397;97;300;499;501
"5229";"2. Neyman known";408;93;315;463;537
"5230";"3. RSIHR Known";467;66;401;363;637
"5231";"4. Rosenberger known";562;30;532;144;856
"5232";"5. Optimal adjusted";404;112;292;540;460
"5233";"1. Random";392;101;291;512;488
"5234";"6. Biased  coin";382;91;291;502;499
"5235";"2. Neyman known";424;87;337;434;566
"5236";"3. RSIHR Known";460;86;374;380;620
"5237";"4. Rosenberger known";542;24;518;132;868
"5238";"5. Optimal adjusted";390;119;271;549;451
"5239";"1. Random";406;103;303;493;507
"5240";"6. Biased  coin";373;94;279;500;500
"5241";"2. Neyman known";410;89;321;456;544
"5242";"3. RSIHR Known";438;75;363;383;617
"5243";"4. Rosenberger known";535;22;513;130;870
"5244";"5. Optimal adjusted";373;105;268;546;454
"5245";"1. Random";388;116;272;504;496
"5246";"6. Biased  coin";427;104;323;499;501
"5247";"2. Neyman known";401;95;306;452;548
"5248";"3. RSIHR Known";446;87;359;370;630
"5249";"4. Rosenberger known";524;37;487;141;859
"5250";"5. Optimal adjusted";382;110;272;518;482
"5251";"1. Random";399;102;297;497;503
"5252";"6. Biased  coin";404;97;307;499;501
"5253";"2. Neyman known";418;87;331;452;548
"5254";"3. RSIHR Known";453;69;384;383;617
"5255";"4. Rosenberger known";532;22;510;148;852
"5256";"5. Optimal adjusted";375;103;272;558;442
"5257";"1. Random";397;93;304;505;495
"5258";"6. Biased  coin";401;92;309;501;500
"5259";"2. Neyman known";415;82;333;431;569
"5260";"3. RSIHR Known";470;72;398;355;645
"5261";"4. Rosenberger known";560;27;533;130;870
"5262";"5. Optimal adjusted";396;103;293;523;477
"5263";"1. Random";378;99;279;513;487
"5264";"6. Biased  coin";409;99;310;502;498
"5265";"2. Neyman known";413;92;321;439;561
"5266";"3. RSIHR Known";455;79;376;378;622
"5267";"4. Rosenberger known";543;27;516;137;863
"5268";"5. Optimal adjusted";381;106;275;531;469
"5269";"1. Random";390;88;302;490;510
"5270";"6. Biased  coin";402;108;294;499;501
"5271";"2. Neyman known";416;104;312;471;529
"5272";"3. RSIHR Known";461;70;391;350;650
"5273";"4. Rosenberger known";546;32;514;140;860
"5274";"5. Optimal adjusted";394;121;273;536;464
"5275";"1. Random";393;108;285;520;480
"5276";"6. Biased  coin";385;98;287;503;497
"5277";"2. Neyman known";426;87;339;454;546
"5278";"3. RSIHR Known";457;67;390;343;657
"5279";"4. Rosenberger known";538;21;517;142;858
"5280";"5. Optimal adjusted";393;102;291;517;483
"5281";"1. Random";400;102;298;506;494
"5282";"6. Biased  coin";380;95;285;501;500
"5283";"2. Neyman known";407;89;318;446;554
"5284";"3. RSIHR Known";438;64;374;371;629
"5285";"4. Rosenberger known";515;24;491;142;858
"5286";"5. Optimal adjusted";375;104;271;530;470
"5287";"1. Random";422;106;316;470;530
"5288";"6. Biased  coin";425;129;296;502;499
"5289";"2. Neyman known";437;111;326;444;556
"5290";"3. RSIHR Known";455;71;384;352;648
"5291";"4. Rosenberger known";554;28;526;126;874
"5292";"5. Optimal adjusted";423;128;295;526;474
"5293";"1. Random";383;86;297;495;505
"5294";"6. Biased  coin";380;89;291;499;501
"5295";"2. Neyman known";405;84;321;461;539
"5296";"3. RSIHR Known";429;64;365;377;623
"5297";"4. Rosenberger known";517;28;489;144;856
"5298";"5. Optimal adjusted";355;100;255;561;439
"5299";"1. Random";397;106;291;504;496
"5300";"6. Biased  coin";391;97;294;502;500
"5301";"2. Neyman known";440;98;342;440;560
"5302";"3. RSIHR Known";435;62;373;362;638
"5303";"4. Rosenberger known";536;28;508;141;859
"5304";"5. Optimal adjusted";373;106;267;552;448
"5305";"1. Random";382;93;289;491;509
"5306";"6. Biased  coin";376;89;287;500;500
"5307";"2. Neyman known";397;78;319;444;556
"5308";"3. RSIHR Known";437;61;376;360;640
"5309";"4. Rosenberger known";521;21;500;140;860
"5310";"5. Optimal adjusted";368;90;278;551;449
"5311";"1. Random";401;97;304;508;492
"5312";"6. Biased  coin";414;109;305;500;502
"5313";"2. Neyman known";435;86;349;429;571
"5314";"3. RSIHR Known";463;75;388;370;630
"5315";"4. Rosenberger known";555;27;528;130;870
"5316";"5. Optimal adjusted";372;99;273;536;464
"5317";"1. Random";399;95;304;493;507
"5318";"6. Biased  coin";371;91;280;500;500
"5319";"2. Neyman known";400;74;326;440;560
"5320";"3. RSIHR Known";441;74;367;367;633
"5321";"4. Rosenberger known";534;25;509;129;871
"5322";"5. Optimal adjusted";379;100;279;530;470
"5323";"1. Random";388;91;297;489;511
"5324";"6. Biased  coin";406;106;300;501;501
"5325";"2. Neyman known";419;88;331;434;566
"5326";"3. RSIHR Known";465;75;390;339;661
"5327";"4. Rosenberger known";544;28;516;137;863
"5328";"5. Optimal adjusted";390;113;277;537;463
"5329";"1. Random";390;93;297;496;504
"5330";"6. Biased  coin";397;100;297;499;501
"5331";"2. Neyman known";408;89;319;448;552
"5332";"3. RSIHR Known";436;55;381;349;651
"5333";"4. Rosenberger known";535;24;511;133;867
"5334";"5. Optimal adjusted";382;104;278;533;467
"5335";"1. Random";403;91;312;476;524
"5336";"6. Biased  coin";395;89;306;500;500
"5337";"2. Neyman known";435;80;355;424;576
"5338";"3. RSIHR Known";485;75;410;337;663
"5339";"4. Rosenberger known";540;25;515;141;859
"5340";"5. Optimal adjusted";382;108;274;533;467
"5341";"1. Random";401;96;305;507;493
"5342";"6. Biased  coin";376;88;288;500;500
"5343";"2. Neyman known";429;84;345;451;549
"5344";"3. RSIHR Known";445;64;381;390;610
"5345";"4. Rosenberger known";554;23;531;131;869
"5346";"5. Optimal adjusted";380;108;272;552;448
"5347";"1. Random";402;100;302;473;527
"5348";"6. Biased  coin";400;105;295;502;500
"5349";"2. Neyman known";396;88;308;449;551
"5350";"3. RSIHR Known";461;74;387;353;647
"5351";"4. Rosenberger known";533;29;504;135;865
"5352";"5. Optimal adjusted";361;107;254;540;460
"5353";"1. Random";379;103;276;497;503
"5354";"6. Biased  coin";392;100;292;504;496
"5355";"2. Neyman known";422;98;324;473;527
"5356";"3. RSIHR Known";439;58;381;347;653
"5357";"4. Rosenberger known";523;27;496;153;847
"5358";"5. Optimal adjusted";371;101;270;548;452
"5359";"1. Random";390;95;295;488;512
"5360";"6. Biased  coin";385;104;281;500;500
"5361";"2. Neyman known";422;97;325;429;571
"5362";"3. RSIHR Known";434;69;365;364;636
"5363";"4. Rosenberger known";521;28;493;135;865
"5364";"5. Optimal adjusted";411;111;300;503;497
"5365";"1. Random";416;117;299;502;498
"5366";"6. Biased  coin";404;92;312;500;501
"5367";"2. Neyman known";444;91;353;443;557
"5368";"3. RSIHR Known";460;85;375;381;619
"5369";"4. Rosenberger known";542;31;511;158;842
"5370";"5. Optimal adjusted";409;101;308;526;474
"5371";"1. Random";398;106;292;498;502
"5372";"6. Biased  coin";378;97;281;501;500
"5373";"2. Neyman known";420;108;312;453;547
"5374";"3. RSIHR Known";429;72;357;369;631
"5375";"4. Rosenberger known";518;29;489;138;862
"5376";"5. Optimal adjusted";369;104;265;532;468
"5377";"1. Random";386;107;279;547;453
"5378";"6. Biased  coin";410;101;309;501;500
"5379";"2. Neyman known";451;93;358;441;559
"5380";"3. RSIHR Known";466;80;386;383;617
"5381";"4. Rosenberger known";556;26;530;138;862
"5382";"5. Optimal adjusted";393;120;273;546;454
"5383";"1. Random";393;88;305;486;514
"5384";"6. Biased  coin";399;95;304;501;500
"5385";"2. Neyman known";425;85;340;445;555
"5386";"3. RSIHR Known";428;71;357;378;622
"5387";"4. Rosenberger known";544;34;510;150;850
"5388";"5. Optimal adjusted";400;93;307;505;495
"5389";"1. Random";400;101;299;518;482
"5390";"6. Biased  coin";411;105;306;502;499
"5391";"2. Neyman known";436;92;344;438;562
"5392";"3. RSIHR Known";463;67;396;352;648
"5393";"4. Rosenberger known";551;34;517;154;846
"5394";"5. Optimal adjusted";381;109;272;555;445
"5395";"1. Random";388;108;280;494;506
"5396";"6. Biased  coin";411;124;287;500;500
"5397";"2. Neyman known";418;108;310;454;546
"5398";"3. RSIHR Known";436;76;360;367;633
"5399";"4. Rosenberger known";524;36;488;147;853
"5400";"5. Optimal adjusted";387;108;279;508;492
"5401";"1. Random";380;98;282;526;474
"5402";"6. Biased  coin";382;89;293;502;500
"5403";"2. Neyman known";393;88;305;469;531
"5404";"3. RSIHR Known";450;66;384;349;651
"5405";"4. Rosenberger known";522;37;485;167;833
"5406";"5. Optimal adjusted";379;109;270;540;460
"5407";"1. Random";389;112;277;512;488
"5408";"6. Biased  coin";397;106;291;502;499
"5409";"2. Neyman known";429;94;335;422;578
"5410";"3. RSIHR Known";453;83;370;365;635
"5411";"4. Rosenberger known";550;33;517;148;852
"5412";"5. Optimal adjusted";402;111;291;504;496
"5413";"1. Random";422;104;318;487;513
"5414";"6. Biased  coin";400;98;302;501;500
"5415";"2. Neyman known";430;85;345;434;566
"5416";"3. RSIHR Known";441;61;380;372;628
"5417";"4. Rosenberger known";551;31;520;138;862
"5418";"5. Optimal adjusted";399;118;281;547;453
"5419";"1. Random";409;110;299;513;487
"5420";"6. Biased  coin";382;96;286;500;500
"5421";"2. Neyman known";416;105;311;459;541
"5422";"3. RSIHR Known";436;76;360;384;616
"5423";"4. Rosenberger known";545;25;520;125;875
"5424";"5. Optimal adjusted";386;120;266;553;447
"5425";"1. Random";386;88;298;505;495
"5426";"6. Biased  coin";399;104;295;500;500
"5427";"2. Neyman known";405;84;321;435;565
"5428";"3. RSIHR Known";438;76;362;381;619
"5429";"4. Rosenberger known";526;19;507;132;868
"5430";"5. Optimal adjusted";382;115;267;560;440
"5431";"1. Random";392;106;286;494;506
"5432";"6. Biased  coin";404;106;298;501;500
"5433";"2. Neyman known";406;88;318;434;566
"5434";"3. RSIHR Known";434;82;352;382;618
"5435";"4. Rosenberger known";531;38;493;152;848
"5436";"5. Optimal adjusted";363;100;263;541;459
"5437";"1. Random";388;101;287;501;499
"5438";"6. Biased  coin";409;116;293;500;501
"5439";"2. Neyman known";392;101;291;475;525
"5440";"3. RSIHR Known";425;67;358;369;631
"5441";"4. Rosenberger known";543;26;517;129;871
"5442";"5. Optimal adjusted";383;114;269;535;465
"5443";"1. Random";379;88;291;520;480
"5444";"6. Biased  coin";423;105;318;501;499
"5445";"2. Neyman known";420;91;329;462;538
"5446";"3. RSIHR Known";449;72;377;378;622
"5447";"4. Rosenberger known";567;24;543;130;870
"5448";"5. Optimal adjusted";386;99;287;556;444
"5449";"1. Random";398;101;297;497;503
"5450";"6. Biased  coin";391;99;292;500;500
"5451";"2. Neyman known";434;97;337;456;544
"5452";"3. RSIHR Known";451;67;384;357;643
"5453";"4. Rosenberger known";543;29;514;142;858
"5454";"5. Optimal adjusted";374;113;261;564;436
"5455";"1. Random";375;81;294;489;511
"5456";"6. Biased  coin";380;88;292;501;499
"5457";"2. Neyman known";393;78;315;457;543
"5458";"3. RSIHR Known";446;67;379;346;654
"5459";"4. Rosenberger known";526;33;493;146;854
"5460";"5. Optimal adjusted";386;101;285;521;479
"5461";"1. Random";404;98;306;493;507
"5462";"6. Biased  coin";403;105;298;501;499
"5463";"2. Neyman known";446;105;341;462;538
"5464";"3. RSIHR Known";477;88;389;347;653
"5465";"4. Rosenberger known";548;32;516;142;858
"5466";"5. Optimal adjusted";392;120;272;538;462
"5467";"1. Random";406;98;308;486;514
"5468";"6. Biased  coin";401;106;295;500;500
"5469";"2. Neyman known";431;90;341;448;552
"5470";"3. RSIHR Known";442;71;371;364;636
"5471";"4. Rosenberger known";538;31;507;152;848
"5472";"5. Optimal adjusted";393;115;278;547;453
"5473";"1. Random";387;113;274;506;494
"5474";"6. Biased  coin";372;103;269;500;500
"5475";"2. Neyman known";408;97;311;450;550
"5476";"3. RSIHR Known";433;65;368;360;640
"5477";"4. Rosenberger known";521;32;489;140;860
"5478";"5. Optimal adjusted";359;104;255;532;468
"5479";"1. Random";382;105;277;508;492
"5480";"6. Biased  coin";414;118;296;499;501
"5481";"2. Neyman known";405;92;313;453;547
"5482";"3. RSIHR Known";461;75;386;337;663
"5483";"4. Rosenberger known";534;29;505;132;868
"5484";"5. Optimal adjusted";392;108;284;518;482
"5485";"1. Random";385;100;285;515;485
"5486";"6. Biased  coin";370;88;282;502;499
"5487";"2. Neyman known";400;87;313;443;557
"5488";"3. RSIHR Known";422;67;355;366;634
"5489";"4. Rosenberger known";534;27;507;134;866
"5490";"5. Optimal adjusted";370;93;277;527;473
"5491";"1. Random";414;113;301;511;489
"5492";"6. Biased  coin";397;106;291;504;500
"5493";"2. Neyman known";429;97;332;442;558
"5494";"3. RSIHR Known";452;82;370;389;611
"5495";"4. Rosenberger known";539;30;509;136;864
"5496";"5. Optimal adjusted";379;112;267;551;449
"5497";"1. Random";390;87;303;493;507
"5498";"6. Biased  coin";398;109;289;501;500
"5499";"2. Neyman known";423;101;322;443;557
"5500";"3. RSIHR Known";435;62;373;369;631
"5501";"4. Rosenberger known";519;22;497;145;855
"5502";"5. Optimal adjusted";386;105;281;548;452
"5503";"1. Random";404;116;288;516;484
"5504";"6. Biased  coin";403;102;301;501;499
"5505";"2. Neyman known";423;98;325;443;557
"5506";"3. RSIHR Known";459;77;382;362;638
"5507";"4. Rosenberger known";551;29;522;111;889
"5508";"5. Optimal adjusted";382;108;274;546;454
"5509";"1. Random";405;90;315;511;489
"5510";"6. Biased  coin";412;102;310;500;500
"5511";"2. Neyman known";408;89;319;458;542
"5512";"3. RSIHR Known";474;74;400;356;644
"5513";"4. Rosenberger known";566;33;533;133;867
"5514";"5. Optimal adjusted";376;118;258;564;436
"5515";"1. Random";383;106;277;517;483
"5516";"6. Biased  coin";401;106;295;501;500
"5517";"2. Neyman known";385;91;294;471;529
"5518";"3. RSIHR Known";438;65;373;365;635
"5519";"4. Rosenberger known";526;24;502;135;865
"5520";"5. Optimal adjusted";369;113;256;552;448
"5521";"1. Random";423;89;334;476;524
"5522";"6. Biased  coin";424;115;309;500;501
"5523";"2. Neyman known";412;89;323;445;555
"5524";"3. RSIHR Known";466;69;397;367;633
"5525";"4. Rosenberger known";569;33;536;130;870
"5526";"5. Optimal adjusted";393;111;282;527;473
"5527";"1. Random";384;101;283;496;504
"5528";"6. Biased  coin";405;106;299;502;500
"5529";"2. Neyman known";385;95;290;478;522
"5530";"3. RSIHR Known";440;85;355;383;617
"5531";"4. Rosenberger known";537;33;504;130;870
"5532";"5. Optimal adjusted";384;106;278;543;457
"5533";"1. Random";396;107;289;496;504
"5534";"6. Biased  coin";384;105;279;502;499
"5535";"2. Neyman known";416;100;316;452;548
"5536";"3. RSIHR Known";457;79;378;358;642
"5537";"4. Rosenberger known";524;26;498;151;849
"5538";"5. Optimal adjusted";383;124;259;551;449
"5539";"1. Random";421;105;316;473;527
"5540";"6. Biased  coin";400;97;303;502;499
"5541";"2. Neyman known";412;85;327;440;560
"5542";"3. RSIHR Known";440;68;372;371;629
"5543";"4. Rosenberger known";542;34;508;137;863
"5544";"5. Optimal adjusted";378;94;284;519;481
"5545";"1. Random";432;108;324;473;527
"5546";"6. Biased  coin";403;104;299;500;500
"5547";"2. Neyman known";443;107;336;443;557
"5548";"3. RSIHR Known";467;83;384;369;631
"5549";"4. Rosenberger known";550;30;520;139;861
"5550";"5. Optimal adjusted";396;126;270;572;428
"5551";"1. Random";418;118;300;501;499
"5552";"6. Biased  coin";412;114;298;500;500
"5553";"2. Neyman known";442;106;336;446;554
"5554";"3. RSIHR Known";479;72;407;331;669
"5555";"4. Rosenberger known";561;37;524;130;870
"5556";"5. Optimal adjusted";398;122;276;513;487
"5557";"1. Random";384;101;283;484;516
"5558";"6. Biased  coin";400;120;280;500;500
"5559";"2. Neyman known";418;103;315;453;547
"5560";"3. RSIHR Known";439;75;364;356;644
"5561";"4. Rosenberger known";516;37;479;145;855
"5562";"5. Optimal adjusted";365;124;241;540;460
"5563";"1. Random";391;107;284;502;498
"5564";"6. Biased  coin";408;115;293;499;501
"5565";"2. Neyman known";405;97;308;461;539
"5566";"3. RSIHR Known";439;83;356;366;634
"5567";"4. Rosenberger known";514;31;483;163;837
"5568";"5. Optimal adjusted";371;100;271;519;481
"5569";"1. Random";401;108;293;511;489
"5570";"6. Biased  coin";392;109;283;501;500
"5571";"2. Neyman known";439;107;332;454;546
"5572";"3. RSIHR Known";435;74;361;369;631
"5573";"4. Rosenberger known";530;27;503;139;861
"5574";"5. Optimal adjusted";391;129;262;546;454
"5575";"1. Random";396;104;292;507;493
"5576";"6. Biased  coin";399;103;296;500;500
"5577";"2. Neyman known";423;98;325;470;530
"5578";"3. RSIHR Known";467;79;388;365;635
"5579";"4. Rosenberger known";565;24;541;134;866
"5580";"5. Optimal adjusted";386;106;280;535;465
"5581";"1. Random";402;106;296;506;494
"5582";"6. Biased  coin";414;109;305;501;500
"5583";"2. Neyman known";415;99;316;455;545
"5584";"3. RSIHR Known";459;71;388;351;649
"5585";"4. Rosenberger known";527;38;489;158;842
"5586";"5. Optimal adjusted";393;111;282;543;457
"5587";"1. Random";388;99;289;514;486
"5588";"6. Biased  coin";378;91;287;500;500
"5589";"2. Neyman known";403;78;325;427;573
"5590";"3. RSIHR Known";438;73;365;361;639
"5591";"4. Rosenberger known";532;28;504;136;864
"5592";"5. Optimal adjusted";373;102;271;538;462
"5593";"1. Random";394;105;289;510;490
"5594";"6. Biased  coin";397;95;302;502;499
"5595";"2. Neyman known";439;109;330;458;542
"5596";"3. RSIHR Known";436;76;360;385;615
"5597";"4. Rosenberger known";539;37;502;161;839
"5598";"5. Optimal adjusted";399;117;282;544;456
"5599";"1. Random";383;113;270;508;492
"5600";"6. Biased  coin";407;114;293;501;499
"5601";"2. Neyman known";421;113;308;464;536
"5602";"3. RSIHR Known";438;76;362;368;632
"5603";"4. Rosenberger known";524;25;499;128;872
"5604";"5. Optimal adjusted";366;127;239;569;431
"5605";"1. Random";391;106;285;511;489
"5606";"6. Biased  coin";386;101;285;502;499
"5607";"2. Neyman known";421;89;332;449;551
"5608";"3. RSIHR Known";413;71;342;385;615
"5609";"4. Rosenberger known";541;23;518;125;875
"5610";"5. Optimal adjusted";366;99;267;531;469
"5611";"1. Random";405;115;290;500;500
"5612";"6. Biased  coin";422;112;310;498;502
"5613";"2. Neyman known";430;98;332;450;550
"5614";"3. RSIHR Known";464;78;386;354;646
"5615";"4. Rosenberger known";562;31;531;138;862
"5616";"5. Optimal adjusted";413;114;299;520;480
"5617";"1. Random";376;106;270;519;481
"5618";"6. Biased  coin";394;112;282;504;501
"5619";"2. Neyman known";424;107;317;434;566
"5620";"3. RSIHR Known";477;87;390;338;662
"5621";"4. Rosenberger known";542;34;508;138;862
"5622";"5. Optimal adjusted";398;113;285;522;478
"5623";"1. Random";396;101;295;523;477
"5624";"6. Biased  coin";423;116;307;501;499
"5625";"2. Neyman known";419;82;337;444;556
"5626";"3. RSIHR Known";481;70;411;339;661
"5627";"4. Rosenberger known";542;22;520;131;869
"5628";"5. Optimal adjusted";374;113;261;559;441
"5629";"1. Random";426;93;333;483;517
"5630";"6. Biased  coin";429;99;330;499;501
"5631";"2. Neyman known";425;87;338;464;536
"5632";"3. RSIHR Known";457;77;380;396;604
"5633";"4. Rosenberger known";557;21;536;145;855
"5634";"5. Optimal adjusted";401;108;293;547;453
"5635";"1. Random";378;100;278;534;466
"5636";"6. Biased  coin";415;97;318;503;498
"5637";"2. Neyman known";414;89;325;477;523
"5638";"3. RSIHR Known";476;78;398;352;648
"5639";"4. Rosenberger known";558;24;534;133;867
"5640";"5. Optimal adjusted";382;105;277;540;460
"5641";"1. Random";404;117;287;510;490
"5642";"6. Biased  coin";428;118;310;501;499
"5643";"2. Neyman known";445;93;352;427;573
"5644";"3. RSIHR Known";470;81;389;368;632
"5645";"4. Rosenberger known";554;25;529;143;857
"5646";"5. Optimal adjusted";406;112;294;540;460
"5647";"1. Random";428;125;303;499;501
"5648";"6. Biased  coin";400;110;290;502;501
"5649";"2. Neyman known";435;99;336;417;583
"5650";"3. RSIHR Known";433;68;365;353;647
"5651";"4. Rosenberger known";532;24;508;124;876
"5652";"5. Optimal adjusted";389;128;261;548;452
"5653";"1. Random";392;100;292;501;499
"5654";"6. Biased  coin";391;101;290;500;500
"5655";"2. Neyman known";426;98;328;446;554
"5656";"3. RSIHR Known";440;79;361;389;611
"5657";"4. Rosenberger known";528;35;493;150;850
"5658";"5. Optimal adjusted";394;124;270;538;462
"5659";"1. Random";393;84;309;484;516
"5660";"6. Biased  coin";378;91;287;505;500
"5661";"2. Neyman known";408;77;331;436;564
"5662";"3. RSIHR Known";453;80;373;377;623
"5663";"4. Rosenberger known";546;26;520;138;862
"5664";"5. Optimal adjusted";391;107;284;530;470
"5665";"1. Random";391;112;279;526;474
"5666";"6. Biased  coin";406;113;293;500;501
"5667";"2. Neyman known";383;88;295;478;522
"5668";"3. RSIHR Known";466;86;380;365;635
"5669";"4. Rosenberger known";535;25;510;130;870
"5670";"5. Optimal adjusted";405;106;299;513;487
"5671";"1. Random";390;96;294;491;509
"5672";"6. Biased  coin";394;106;288;500;501
"5673";"2. Neyman known";407;88;319;460;540
"5674";"3. RSIHR Known";443;75;368;387;613
"5675";"4. Rosenberger known";532;28;504;145;855
"5676";"5. Optimal adjusted";382;98;284;514;486
"5677";"1. Random";430;103;327;494;506
"5678";"6. Biased  coin";420;107;313;500;500
"5679";"2. Neyman known";442;102;340;456;544
"5680";"3. RSIHR Known";459;64;395;364;636
"5681";"4. Rosenberger known";581;31;550;131;869
"5682";"5. Optimal adjusted";409;124;285;547;453
"5683";"1. Random";368;102;266;508;492
"5684";"6. Biased  coin";373;95;278;501;501
"5685";"2. Neyman known";422;98;324;458;542
"5686";"3. RSIHR Known";445;63;382;347;653
"5687";"4. Rosenberger known";536;23;513;133;867
"5688";"5. Optimal adjusted";381;109;272;542;458
"5689";"1. Random";421;100;321;483;517
"5690";"6. Biased  coin";404;95;309;503;500
"5691";"2. Neyman known";435;88;347;435;565
"5692";"3. RSIHR Known";429;63;366;381;619
"5693";"4. Rosenberger known";550;33;517;148;852
"5694";"5. Optimal adjusted";386;114;272;546;454
"5695";"1. Random";377;93;284;530;470
"5696";"6. Biased  coin";384;105;279;502;498
"5697";"2. Neyman known";418;97;321;454;546
"5698";"3. RSIHR Known";447;67;380;343;657
"5699";"4. Rosenberger known";524;33;491;150;850
"5700";"5. Optimal adjusted";393;110;283;501;499
"5701";"1. Random";414;107;307;482;518
"5702";"6. Biased  coin";401;112;289;499;501
"5703";"2. Neyman known";431;102;329;442;558
"5704";"3. RSIHR Known";459;86;373;368;632
"5705";"4. Rosenberger known";531;46;485;154;846
"5706";"5. Optimal adjusted";395;129;266;542;458
"5707";"1. Random";417;101;316;486;514
"5708";"6. Biased  coin";404;102;302;501;499
"5709";"2. Neyman known";417;95;322;447;553
"5710";"3. RSIHR Known";463;84;379;361;639
"5711";"4. Rosenberger known";559;29;530;126;874
"5712";"5. Optimal adjusted";380;112;268;553;447
"5713";"1. Random";362;90;272;521;479
"5714";"6. Biased  coin";371;98;273;500;500
"5715";"2. Neyman known";410;91;319;448;552
"5716";"3. RSIHR Known";442;67;375;366;634
"5717";"4. Rosenberger known";531;28;503;145;855
"5718";"5. Optimal adjusted";384;100;284;538;462
"5719";"1. Random";391;94;297;499;501
"5720";"6. Biased  coin";377;84;293;499;501
"5721";"2. Neyman known";412;86;326;460;540
"5722";"3. RSIHR Known";419;69;350;406;594
"5723";"4. Rosenberger known";543;24;519;125;875
"5724";"5. Optimal adjusted";389;98;291;509;491
"5725";"1. Random";416;103;313;481;519
"5726";"6. Biased  coin";379;100;279;499;501
"5727";"2. Neyman known";419;81;338;438;562
"5728";"3. RSIHR Known";454;74;380;352;648
"5729";"4. Rosenberger known";526;34;492;136;864
"5730";"5. Optimal adjusted";363;97;266;544;456
"5731";"1. Random";369;95;274;522;478
"5732";"6. Biased  coin";397;93;304;503;500
"5733";"2. Neyman known";423;95;328;469;531
"5734";"3. RSIHR Known";470;73;397;339;661
"5735";"4. Rosenberger known";560;32;528;130;870
"5736";"5. Optimal adjusted";381;106;275;538;462
"5737";"1. Random";401;112;289;513;487
"5738";"6. Biased  coin";410;122;288;500;500
"5739";"2. Neyman known";406;91;315;449;551
"5740";"3. RSIHR Known";450;80;370;366;634
"5741";"4. Rosenberger known";532;28;504;152;848
"5742";"5. Optimal adjusted";401;121;280;531;469
"5743";"1. Random";410;112;298;489;511
"5744";"6. Biased  coin";382;92;290;502;500
"5745";"2. Neyman known";436;106;330;458;542
"5746";"3. RSIHR Known";453;84;369;383;617
"5747";"4. Rosenberger known";536;36;500;148;852
"5748";"5. Optimal adjusted";409;123;286;531;469
"5749";"1. Random";392;104;288;515;485
"5750";"6. Biased  coin";385;97;288;500;501
"5751";"2. Neyman known";435;90;345;442;558
"5752";"3. RSIHR Known";429;64;365;379;621
"5753";"4. Rosenberger known";528;34;494;145;855
"5754";"5. Optimal adjusted";386;102;284;531;469
"5755";"1. Random";388;94;294;501;499
"5756";"6. Biased  coin";399;101;298;501;500
"5757";"2. Neyman known";406;80;326;435;565
"5758";"3. RSIHR Known";460;72;388;358;642
"5759";"4. Rosenberger known";538;25;513;138;862
"5760";"5. Optimal adjusted";365;104;261;550;450
"5761";"1. Random";390;103;287;504;496
"5762";"6. Biased  coin";404;101;303;502;500
"5763";"2. Neyman known";432;103;329;432;568
"5764";"3. RSIHR Known";439;76;363;361;639
"5765";"4. Rosenberger known";521;19;502;125;875
"5766";"5. Optimal adjusted";396;118;278;519;481
"5767";"1. Random";411;111;300;503;497
"5768";"6. Biased  coin";402;98;304;500;500
"5769";"2. Neyman known";425;99;326;461;539
"5770";"3. RSIHR Known";475;81;394;357;643
"5771";"4. Rosenberger known";570;31;539;136;864
"5772";"5. Optimal adjusted";380;110;270;544;456
"5773";"1. Random";401;120;281;517;483
"5774";"6. Biased  coin";391;107;284;501;500
"5775";"2. Neyman known";419;94;325;429;571
"5776";"3. RSIHR Known";448;90;358;363;637
"5777";"4. Rosenberger known";527;32;495;146;854
"5778";"5. Optimal adjusted";388;125;263;528;472
"5779";"1. Random";419;99;320;481;519
"5780";"6. Biased  coin";393;91;302;504;498
"5781";"2. Neyman known";424;94;330;452;548
"5782";"3. RSIHR Known";475;84;391;363;637
"5783";"4. Rosenberger known";545;26;519;154;846
"5784";"5. Optimal adjusted";384;96;288;519;481
"5785";"1. Random";378;101;277;492;508
"5786";"6. Biased  coin";373;92;281;500;500
"5787";"2. Neyman known";402;86;316;436;564
"5788";"3. RSIHR Known";420;70;350;377;623
"5789";"4. Rosenberger known";492;18;474;141;859
"5790";"5. Optimal adjusted";373;118;255;555;445
"5791";"1. Random";400;118;282;516;484
"5792";"6. Biased  coin";399;105;294;506;497
"5793";"2. Neyman known";426;99;327;456;544
"5794";"3. RSIHR Known";442;65;377;354;646
"5795";"4. Rosenberger known";527;26;501;135;865
"5796";"5. Optimal adjusted";379;116;263;535;465
"5797";"1. Random";407;95;312;484;516
"5798";"6. Biased  coin";374;94;280;504;498
"5799";"2. Neyman known";432;96;336;446;554
"5800";"3. RSIHR Known";438;82;356;391;609
"5801";"4. Rosenberger known";547;24;523;135;865
"5802";"5. Optimal adjusted";398;109;289;523;477
"5803";"1. Random";387;102;285;505;495
"5804";"6. Biased  coin";404;92;312;500;501
"5805";"2. Neyman known";412;98;314;470;530
"5806";"3. RSIHR Known";447;68;379;380;620
"5807";"4. Rosenberger known";526;26;500;160;840
"5808";"5. Optimal adjusted";372;109;263;563;437
"5809";"1. Random";411;92;319;477;523
"5810";"6. Biased  coin";388;98;290;500;500
"5811";"2. Neyman known";406;82;324;432;568
"5812";"3. RSIHR Known";455;91;364;375;625
"5813";"4. Rosenberger known";543;34;509;144;856
"5814";"5. Optimal adjusted";390;109;281;536;464
"5815";"1. Random";384;85;299;492;508
"5816";"6. Biased  coin";377;93;284;500;501
"5817";"2. Neyman known";429;69;360;416;584
"5818";"3. RSIHR Known";452;75;377;381;619
"5819";"4. Rosenberger known";543;24;519;135;865
"5820";"5. Optimal adjusted";387;113;274;539;461
"5821";"1. Random";395;107;288;495;505
"5822";"6. Biased  coin";388;103;285;500;501
"5823";"2. Neyman known";406;85;321;434;566
"5824";"3. RSIHR Known";454;89;365;382;618
"5825";"4. Rosenberger known";531;32;499;135;865
"5826";"5. Optimal adjusted";392;113;279;517;483
"5827";"1. Random";429;113;316;482;518
"5828";"6. Biased  coin";421;106;315;501;500
"5829";"2. Neyman known";422;94;328;451;549
"5830";"3. RSIHR Known";452;77;375;374;626
"5831";"4. Rosenberger known";563;32;531;144;856
"5832";"5. Optimal adjusted";390;124;266;552;448
"5833";"1. Random";386;102;284;512;488
"5834";"6. Biased  coin";441;113;328;502;500
"5835";"2. Neyman known";435;92;343;447;553
"5836";"3. RSIHR Known";483;80;403;353;647
"5837";"4. Rosenberger known";567;43;524;165;835
"5838";"5. Optimal adjusted";390;102;288;539;461
"5839";"1. Random";401;104;297;496;504
"5840";"6. Biased  coin";399;104;295;501;500
"5841";"2. Neyman known";414;96;318;472;528
"5842";"3. RSIHR Known";463;67;396;361;639
"5843";"4. Rosenberger known";532;22;510;146;854
"5844";"5. Optimal adjusted";384;103;281;538;462
"5845";"1. Random";388;104;284;489;511
"5846";"6. Biased  coin";385;110;275;501;500
"5847";"2. Neyman known";409;98;311;454;546
"5848";"3. RSIHR Known";432;85;347;394;606
"5849";"4. Rosenberger known";517;32;485;145;855
"5850";"5. Optimal adjusted";376;122;254;559;441
"5851";"1. Random";409;109;300;508;492
"5852";"6. Biased  coin";411;108;303;502;499
"5853";"2. Neyman known";413;96;317;463;537
"5854";"3. RSIHR Known";465;78;387;371;629
"5855";"4. Rosenberger known";542;22;520;127;873
"5856";"5. Optimal adjusted";388;115;273;532;468
"5857";"1. Random";401;95;306;504;496
"5858";"6. Biased  coin";380;91;289;497;503
"5859";"2. Neyman known";387;89;298;462;538
"5860";"3. RSIHR Known";444;85;359;383;617
"5861";"4. Rosenberger known";535;32;503;143;857
"5862";"5. Optimal adjusted";360;102;258;532;468
"5863";"1. Random";388;107;281;499;501
"5864";"6. Biased  coin";382;89;293;501;499
"5865";"2. Neyman known";423;102;321;453;547
"5866";"3. RSIHR Known";451;66;385;355;645
"5867";"4. Rosenberger known";543;29;514;132;868
"5868";"5. Optimal adjusted";380;108;272;525;475
"5869";"1. Random";382;100;282;517;483
"5870";"6. Biased  coin";403;101;302;502;499
"5871";"2. Neyman known";417;88;329;443;557
"5872";"3. RSIHR Known";467;69;398;335;665
"5873";"4. Rosenberger known";552;27;525;135;865
"5874";"5. Optimal adjusted";382;105;277;560;440
"5875";"1. Random";389;99;290;493;507
"5876";"6. Biased  coin";369;88;281;500;501
"5877";"2. Neyman known";372;83;289;468;532
"5878";"3. RSIHR Known";420;76;344;389;611
"5879";"4. Rosenberger known";522;33;489;145;855
"5880";"5. Optimal adjusted";364;103;261;538;462
"5881";"1. Random";384;93;291;476;524
"5882";"6. Biased  coin";394;115;279;502;498
"5883";"2. Neyman known";398;95;303;459;541
"5884";"3. RSIHR Known";443;73;370;359;641
"5885";"4. Rosenberger known";511;30;481;158;842
"5886";"5. Optimal adjusted";375;113;262;529;471
"5887";"1. Random";396;106;290;508;492
"5888";"6. Biased  coin";396;96;300;500;500
"5889";"2. Neyman known";419;98;321;469;531
"5890";"3. RSIHR Known";479;84;395;340;660
"5891";"4. Rosenberger known";532;30;502;144;856
"5892";"5. Optimal adjusted";369;115;254;568;432
"5893";"1. Random";430;118;312;467;533
"5894";"6. Biased  coin";409;117;292;502;499
"5895";"2. Neyman known";429;96;333;450;550
"5896";"3. RSIHR Known";484;93;391;365;635
"5897";"4. Rosenberger known";548;33;515;137;863
"5898";"5. Optimal adjusted";387;122;265;543;457
"5899";"1. Random";367;102;265;530;470
"5900";"6. Biased  coin";386;103;283;501;500
"5901";"2. Neyman known";404;89;315;459;541
"5902";"3. RSIHR Known";464;87;377;360;640
"5903";"4. Rosenberger known";517;26;491;146;854
"5904";"5. Optimal adjusted";388;105;283;525;475
"5905";"1. Random";413;104;309;491;509
"5906";"6. Biased  coin";397;102;295;500;501
"5907";"2. Neyman known";413;96;317;462;538
"5908";"3. RSIHR Known";455;82;373;372;628
"5909";"4. Rosenberger known";532;25;507;134;866
"5910";"5. Optimal adjusted";398;115;283;535;465
"5911";"1. Random";377;85;292;487;513
"5912";"6. Biased  coin";382;91;291;500;501
"5913";"2. Neyman known";412;81;331;438;562
"5914";"3. RSIHR Known";413;59;354;373;627
"5915";"4. Rosenberger known";503;21;482;143;857
"5916";"5. Optimal adjusted";339;100;239;540;460
"5917";"1. Random";410;114;296;489;511
"5918";"6. Biased  coin";368;98;270;500;500
"5919";"2. Neyman known";391;75;316;441;559
"5920";"3. RSIHR Known";427;65;362;355;645
"5921";"4. Rosenberger known";515;34;481;149;851
"5922";"5. Optimal adjusted";386;96;290;498;502
"5923";"1. Random";407;110;297;505;495
"5924";"6. Biased  coin";404;106;298;503;499
"5925";"2. Neyman known";431;96;335;430;570
"5926";"3. RSIHR Known";464;77;387;344;656
"5927";"4. Rosenberger known";547;32;515;149;851
"5928";"5. Optimal adjusted";414;119;295;522;478
"5929";"1. Random";403;99;304;507;493
"5930";"6. Biased  coin";390;90;300;500;500
"5931";"2. Neyman known";436;97;339;441;559
"5932";"3. RSIHR Known";441;77;364;373;627
"5933";"4. Rosenberger known";554;23;531;122;878
"5934";"5. Optimal adjusted";392;103;289;535;465
"5935";"1. Random";403;87;316;475;525
"5936";"6. Biased  coin";407;110;297;501;500
"5937";"2. Neyman known";427;83;344;435;565
"5938";"3. RSIHR Known";438;70;368;362;638
"5939";"4. Rosenberger known";529;25;504;141;859
"5940";"5. Optimal adjusted";400;113;287;527;473
"5941";"1. Random";396;111;285;497;503
"5942";"6. Biased  coin";404;97;307;502;499
"5943";"2. Neyman known";414;88;326;441;559
"5944";"3. RSIHR Known";467;75;392;361;639
"5945";"4. Rosenberger known";540;28;512;143;857
"5946";"5. Optimal adjusted";381;110;271;542;458
"5947";"1. Random";404;106;298;493;507
"5948";"6. Biased  coin";399;113;286;500;500
"5949";"2. Neyman known";412;104;308;469;531
"5950";"3. RSIHR Known";432;67;365;384;616
"5951";"4. Rosenberger known";533;29;504;139;861
"5952";"5. Optimal adjusted";374;111;263;545;455
"5953";"1. Random";395;111;284;510;490
"5954";"6. Biased  coin";418;116;302;500;500
"5955";"2. Neyman known";419;89;330;439;561
"5956";"3. RSIHR Known";480;81;399;369;631
"5957";"4. Rosenberger known";545;32;513;147;853
"5958";"5. Optimal adjusted";389;113;276;556;444
"5959";"1. Random";406;105;301;496;504
"5960";"6. Biased  coin";406;104;302;502;500
"5961";"2. Neyman known";432;95;337;444;556
"5962";"3. RSIHR Known";457;74;383;377;623
"5963";"4. Rosenberger known";557;27;530;133;867
"5964";"5. Optimal adjusted";383;103;280;520;480
"5965";"1. Random";416;106;310;486;514
"5966";"6. Biased  coin";398;103;295;501;500
"5967";"2. Neyman known";418;97;321;454;546
"5968";"3. RSIHR Known";456;82;374;378;622
"5969";"4. Rosenberger known";539;26;513;145;855
"5970";"5. Optimal adjusted";390;121;269;560;440
"5971";"1. Random";395;95;300;521;479
"5972";"6. Biased  coin";413;107;306;502;498
"5973";"2. Neyman known";414;78;336;433;567
"5974";"3. RSIHR Known";450;65;385;357;643
"5975";"4. Rosenberger known";543;26;517;138;862
"5976";"5. Optimal adjusted";395;95;300;498;502
"5977";"1. Random";400;117;283;523;477
"5978";"6. Biased  coin";415;112;303;502;499
"5979";"2. Neyman known";428;101;327;458;542
"5980";"3. RSIHR Known";454;73;381;366;634
"5981";"4. Rosenberger known";538;24;514;132;868
"5982";"5. Optimal adjusted";398;124;274;554;446
"5983";"1. Random";381;92;289;495;505
"5984";"6. Biased  coin";397;93;304;501;501
"5985";"2. Neyman known";401;82;319;444;556
"5986";"3. RSIHR Known";444;69;375;360;640
"5987";"4. Rosenberger known";533;23;510;139;861
"5988";"5. Optimal adjusted";397;102;295;519;481
"5989";"1. Random";392;97;295;504;496
"5990";"6. Biased  coin";402;102;300;503;499
"5991";"2. Neyman known";423;78;345;422;578
"5992";"3. RSIHR Known";448;61;387;350;650
"5993";"4. Rosenberger known";533;30;503;160;840
"5994";"5. Optimal adjusted";368;102;266;548;452
"5995";"1. Random";400;103;297;487;513
"5996";"6. Biased  coin";406;104;302;501;500
"5997";"2. Neyman known";413;85;328;443;557
"5998";"3. RSIHR Known";431;78;353;374;626
"5999";"4. Rosenberger known";532;30;502;145;855
"6000";"5. Optimal adjusted";390;109;281;524;476
