"";"ModelNumber";"Model";"Run";"Successes";"Successes_A";"Successes_B";"Allocated_A";"Allocated_B"
"1";"20. Neyman CARA";"20. Neyman CARA";1;414;107;307;513;487
"2";"20. Neyman CARA";"20. Neyman CARA";2;392;97;295;499;501
"3";"20. Neyman CARA";"20. Neyman CARA";3;198;191;7;992;8
"4";"20. Neyman CARA";"20. Neyman CARA";4;217;212;5;993;7
"5";"20. Neyman CARA";"20. Neyman CARA";5;394;124;270;560;440
"6";"20. Neyman CARA";"20. Neyman CARA";6;200;198;2;994;6
"7";"20. Neyman CARA";"20. Neyman CARA";7;412;98;314;478;522
"8";"20. Neyman CARA";"20. Neyman CARA";8;541;132;409;513;487
"9";"20. Neyman CARA";"20. Neyman CARA";9;394;102;292;512;488
"10";"20. Neyman CARA";"20. Neyman CARA";10;551;160;391;514;486
"11";"20. Neyman CARA";"20. Neyman CARA";11;393;87;306;473;527
"12";"20. Neyman CARA";"20. Neyman CARA";12;515;133;382;515;485
"13";"20. Neyman CARA";"20. Neyman CARA";13;224;219;5;994;6
"14";"20. Neyman CARA";"20. Neyman CARA";14;505;125;380;514;486
"15";"20. Neyman CARA";"20. Neyman CARA";15;438;123;315;503;497
"16";"20. Neyman CARA";"20. Neyman CARA";16;228;225;3;994;6
"17";"20. Neyman CARA";"20. Neyman CARA";17;218;213;5;994;6
"18";"20. Neyman CARA";"20. Neyman CARA";18;405;116;289;500;500
"19";"20. Neyman CARA";"20. Neyman CARA";19;522;160;362;517;483
"20";"20. Neyman CARA";"20. Neyman CARA";20;225;216;9;990;10
"21";"20. Neyman CARA";"20. Neyman CARA";21;250;43;207;485;515
"22";"20. Neyman CARA";"20. Neyman CARA";22;537;151;386;515;485
"23";"20. Neyman CARA";"20. Neyman CARA";23;559;159;400;513;487
"24";"20. Neyman CARA";"20. Neyman CARA";24;533;144;389;514;486
"25";"20. Neyman CARA";"20. Neyman CARA";25;422;91;331;451;549
"26";"20. Neyman CARA";"20. Neyman CARA";26;394;94;300;494;506
"27";"20. Neyman CARA";"20. Neyman CARA";27;385;110;275;519;481
"28";"20. Neyman CARA";"20. Neyman CARA";28;375;108;267;600;400
"29";"20. Neyman CARA";"20. Neyman CARA";29;225;203;22;968;32
"30";"20. Neyman CARA";"20. Neyman CARA";30;546;153;393;514;486
"31";"20. Neyman CARA";"20. Neyman CARA";31;541;147;394;515;485
"32";"20. Neyman CARA";"20. Neyman CARA";32;409;118;291;510;490
"33";"20. Neyman CARA";"20. Neyman CARA";33;225;221;4;993;7
"34";"20. Neyman CARA";"20. Neyman CARA";34;464;129;335;501;499
"35";"20. Neyman CARA";"20. Neyman CARA";35;409;99;310;501;499
"36";"20. Neyman CARA";"20. Neyman CARA";36;207;205;2;993;7
"37";"20. Neyman CARA";"20. Neyman CARA";37;428;123;305;515;485
"38";"20. Neyman CARA";"20. Neyman CARA";38;551;150;401;516;484
"39";"20. Neyman CARA";"20. Neyman CARA";39;414;118;296;493;507
"40";"20. Neyman CARA";"20. Neyman CARA";40;225;219;6;993;7
"41";"20. Neyman CARA";"20. Neyman CARA";41;478;133;345;523;477
"42";"20. Neyman CARA";"20. Neyman CARA";42;552;157;395;514;486
"43";"20. Neyman CARA";"20. Neyman CARA";43;542;160;382;515;485
"44";"20. Neyman CARA";"20. Neyman CARA";44;181;176;5;993;7
"45";"20. Neyman CARA";"20. Neyman CARA";45;531;149;382;515;485
"46";"20. Neyman CARA";"20. Neyman CARA";46;408;88;320;471;529
"47";"20. Neyman CARA";"20. Neyman CARA";47;382;92;290;507;493
"48";"20. Neyman CARA";"20. Neyman CARA";48;214;211;3;993;7
"49";"20. Neyman CARA";"20. Neyman CARA";49;533;140;393;516;484
"50";"20. Neyman CARA";"20. Neyman CARA";50;384;90;294;512;488
"51";"20. Neyman CARA";"20. Neyman CARA";51;408;107;301;497;503
"52";"20. Neyman CARA";"20. Neyman CARA";52;532;158;374;519;481
"53";"20. Neyman CARA";"20. Neyman CARA";53;519;148;371;515;485
"54";"20. Neyman CARA";"20. Neyman CARA";54;261;53;208;486;514
"55";"20. Neyman CARA";"20. Neyman CARA";55;209;206;3;995;5
"56";"20. Neyman CARA";"20. Neyman CARA";56;373;87;286;529;471
"57";"20. Neyman CARA";"20. Neyman CARA";57;354;87;267;483;517
"58";"20. Neyman CARA";"20. Neyman CARA";58;411;115;296;513;487
"59";"20. Neyman CARA";"20. Neyman CARA";59;404;132;272;531;469
"60";"20. Neyman CARA";"20. Neyman CARA";60;203;187;16;976;24
"61";"20. Neyman CARA";"20. Neyman CARA";61;181;178;3;995;5
"62";"20. Neyman CARA";"20. Neyman CARA";62;389;108;281;517;483
"63";"20. Neyman CARA";"20. Neyman CARA";63;387;108;279;543;457
"64";"20. Neyman CARA";"20. Neyman CARA";64;223;219;4;993;7
"65";"20. Neyman CARA";"20. Neyman CARA";65;556;159;397;514;486
"66";"20. Neyman CARA";"20. Neyman CARA";66;189;183;6;993;7
"67";"20. Neyman CARA";"20. Neyman CARA";67;548;153;395;515;485
"68";"20. Neyman CARA";"20. Neyman CARA";68;201;196;5;994;6
"69";"20. Neyman CARA";"20. Neyman CARA";69;405;103;302;527;473
"70";"20. Neyman CARA";"20. Neyman CARA";70;528;148;380;515;485
"71";"20. Neyman CARA";"20. Neyman CARA";71;216;208;8;989;11
"72";"20. Neyman CARA";"20. Neyman CARA";72;212;209;3;995;5
"73";"20. Neyman CARA";"20. Neyman CARA";73;391;85;306;459;541
"74";"20. Neyman CARA";"20. Neyman CARA";74;227;45;182;485;515
"75";"20. Neyman CARA";"20. Neyman CARA";75;413;81;332;455;545
"76";"20. Neyman CARA";"20. Neyman CARA";76;321;76;245;478;522
"77";"20. Neyman CARA";"20. Neyman CARA";77;197;192;5;994;6
"78";"20. Neyman CARA";"20. Neyman CARA";78;554;155;399;514;486
"79";"20. Neyman CARA";"20. Neyman CARA";79;406;107;299;485;515
"80";"20. Neyman CARA";"20. Neyman CARA";80;211;203;8;986;14
"81";"20. Neyman CARA";"20. Neyman CARA";81;213;208;5;993;7
"82";"20. Neyman CARA";"20. Neyman CARA";82;361;116;245;615;385
"83";"20. Neyman CARA";"20. Neyman CARA";83;392;96;296;505;495
"84";"20. Neyman CARA";"20. Neyman CARA";84;233;230;3;994;6
"85";"20. Neyman CARA";"20. Neyman CARA";85;181;177;4;994;6
"86";"20. Neyman CARA";"20. Neyman CARA";86;411;97;314;459;541
"87";"20. Neyman CARA";"20. Neyman CARA";87;378;106;272;556;444
"88";"20. Neyman CARA";"20. Neyman CARA";88;562;172;390;515;485
"89";"20. Neyman CARA";"20. Neyman CARA";89;421;110;311;491;509
"90";"20. Neyman CARA";"20. Neyman CARA";90;186;179;7;990;10
"91";"20. Neyman CARA";"20. Neyman CARA";91;405;108;297;511;489
"92";"20. Neyman CARA";"20. Neyman CARA";92;530;146;384;520;480
"93";"20. Neyman CARA";"20. Neyman CARA";93;529;145;384;514;486
"94";"20. Neyman CARA";"20. Neyman CARA";94;402;90;312;491;509
"95";"20. Neyman CARA";"20. Neyman CARA";95;200;194;6;993;7
"96";"20. Neyman CARA";"20. Neyman CARA";96;222;217;5;994;6
"97";"20. Neyman CARA";"20. Neyman CARA";97;400;97;303;499;501
"98";"20. Neyman CARA";"20. Neyman CARA";98;269;159;110;825;175
"99";"20. Neyman CARA";"20. Neyman CARA";99;205;199;6;991;9
"100";"20. Neyman CARA";"20. Neyman CARA";100;399;90;309;482;518
"101";"20. Neyman CARA";"20. Neyman CARA";101;370;104;266;556;444
"102";"20. Neyman CARA";"20. Neyman CARA";102;420;97;323;476;524
"103";"20. Neyman CARA";"20. Neyman CARA";103;406;109;297;500;500
"104";"20. Neyman CARA";"20. Neyman CARA";104;386;95;291;513;487
"105";"20. Neyman CARA";"20. Neyman CARA";105;210;206;4;994;6
"106";"20. Neyman CARA";"20. Neyman CARA";106;413;111;302;507;493
"107";"20. Neyman CARA";"20. Neyman CARA";107;252;47;205;486;514
"108";"20. Neyman CARA";"20. Neyman CARA";108;267;57;210;488;512
"109";"20. Neyman CARA";"20. Neyman CARA";109;191;186;5;994;6
"110";"20. Neyman CARA";"20. Neyman CARA";110;417;114;303;505;495
"111";"20. Neyman CARA";"20. Neyman CARA";111;551;154;397;515;485
"112";"20. Neyman CARA";"20. Neyman CARA";112;397;107;290;503;497
"113";"20. Neyman CARA";"20. Neyman CARA";113;527;146;381;516;484
"114";"20. Neyman CARA";"20. Neyman CARA";114;248;166;82;863;137
"115";"20. Neyman CARA";"20. Neyman CARA";115;545;165;380;515;485
"116";"20. Neyman CARA";"20. Neyman CARA";116;510;128;382;513;487
"117";"20. Neyman CARA";"20. Neyman CARA";117;426;112;314;488;512
"118";"20. Neyman CARA";"20. Neyman CARA";118;194;188;6;992;8
"119";"20. Neyman CARA";"20. Neyman CARA";119;400;116;284;536;464
"120";"20. Neyman CARA";"20. Neyman CARA";120;342;64;278;462;538
"121";"20. Neyman CARA";"20. Neyman CARA";121;401;89;312;486;514
"122";"20. Neyman CARA";"20. Neyman CARA";122;186;182;4;994;6
"123";"20. Neyman CARA";"20. Neyman CARA";123;241;232;9;986;14
"124";"20. Neyman CARA";"20. Neyman CARA";124;525;172;353;530;470
"125";"20. Neyman CARA";"20. Neyman CARA";125;250;52;198;489;511
"126";"20. Neyman CARA";"20. Neyman CARA";126;414;97;317;476;524
"127";"20. Neyman CARA";"20. Neyman CARA";127;195;191;4;993;7
"128";"20. Neyman CARA";"20. Neyman CARA";128;293;66;227;489;511
"129";"20. Neyman CARA";"20. Neyman CARA";129;207;202;5;994;6
"130";"20. Neyman CARA";"20. Neyman CARA";130;391;91;300;482;518
"131";"20. Neyman CARA";"20. Neyman CARA";131;195;188;7;989;11
"132";"20. Neyman CARA";"20. Neyman CARA";132;389;111;278;497;503
"133";"20. Neyman CARA";"20. Neyman CARA";133;398;101;297;489;511
"134";"20. Neyman CARA";"20. Neyman CARA";134;385;77;308;477;523
"135";"20. Neyman CARA";"20. Neyman CARA";135;401;97;304;495;505
"136";"20. Neyman CARA";"20. Neyman CARA";136;395;94;301;504;496
"137";"20. Neyman CARA";"20. Neyman CARA";137;211;207;4;993;7
"138";"20. Neyman CARA";"20. Neyman CARA";138;447;110;337;501;499
"139";"20. Neyman CARA";"20. Neyman CARA";139;395;96;299;493;507
"140";"20. Neyman CARA";"20. Neyman CARA";140;203;199;4;995;5
"141";"20. Neyman CARA";"20. Neyman CARA";141;398;84;314;486;514
"142";"20. Neyman CARA";"20. Neyman CARA";142;221;217;4;986;14
"143";"20. Neyman CARA";"20. Neyman CARA";143;430;106;324;486;514
"144";"20. Neyman CARA";"20. Neyman CARA";144;185;180;5;993;7
"145";"20. Neyman CARA";"20. Neyman CARA";145;403;111;292;546;454
"146";"20. Neyman CARA";"20. Neyman CARA";146;224;219;5;994;6
"147";"20. Neyman CARA";"20. Neyman CARA";147;541;144;397;515;485
"148";"20. Neyman CARA";"20. Neyman CARA";148;229;227;2;994;6
"149";"20. Neyman CARA";"20. Neyman CARA";149;380;108;272;496;504
"150";"20. Neyman CARA";"20. Neyman CARA";150;294;61;233;472;528
"151";"20. Neyman CARA";"20. Neyman CARA";151;212;207;5;992;8
"152";"20. Neyman CARA";"20. Neyman CARA";152;559;158;401;515;485
"153";"20. Neyman CARA";"20. Neyman CARA";153;403;99;304;497;503
"154";"20. Neyman CARA";"20. Neyman CARA";154;389;99;290;503;497
"155";"20. Neyman CARA";"20. Neyman CARA";155;425;115;310;486;514
"156";"20. Neyman CARA";"20. Neyman CARA";156;196;192;4;995;5
"157";"20. Neyman CARA";"20. Neyman CARA";157;412;116;296;506;494
"158";"20. Neyman CARA";"20. Neyman CARA";158;521;141;380;515;485
"159";"20. Neyman CARA";"20. Neyman CARA";159;216;213;3;995;5
"160";"20. Neyman CARA";"20. Neyman CARA";160;408;100;308;479;521
"161";"20. Neyman CARA";"20. Neyman CARA";161;183;179;4;993;7
"162";"20. Neyman CARA";"20. Neyman CARA";162;390;90;300;506;494
"163";"20. Neyman CARA";"20. Neyman CARA";163;209;199;10;985;15
"164";"20. Neyman CARA";"20. Neyman CARA";164;202;197;5;993;7
"165";"20. Neyman CARA";"20. Neyman CARA";165;402;113;289;512;488
"166";"20. Neyman CARA";"20. Neyman CARA";166;370;115;255;561;439
"167";"20. Neyman CARA";"20. Neyman CARA";167;400;113;287;529;471
"168";"20. Neyman CARA";"20. Neyman CARA";168;212;205;7;992;8
"169";"20. Neyman CARA";"20. Neyman CARA";169;399;113;286;508;492
"170";"20. Neyman CARA";"20. Neyman CARA";170;258;52;206;488;512
"171";"20. Neyman CARA";"20. Neyman CARA";171;414;107;307;496;504
"172";"20. Neyman CARA";"20. Neyman CARA";172;206;201;5;994;6
"173";"20. Neyman CARA";"20. Neyman CARA";173;450;128;322;516;484
"174";"20. Neyman CARA";"20. Neyman CARA";174;209;204;5;989;11
"175";"20. Neyman CARA";"20. Neyman CARA";175;382;101;281;530;470
"176";"20. Neyman CARA";"20. Neyman CARA";176;233;191;42;934;66
"177";"20. Neyman CARA";"20. Neyman CARA";177;422;109;313;480;520
"178";"20. Neyman CARA";"20. Neyman CARA";178;455;114;341;487;513
"179";"20. Neyman CARA";"20. Neyman CARA";179;207;204;3;995;5
"180";"20. Neyman CARA";"20. Neyman CARA";180;273;55;218;484;516
"181";"20. Neyman CARA";"20. Neyman CARA";181;421;99;322;514;486
"182";"20. Neyman CARA";"20. Neyman CARA";182;195;190;5;991;9
"183";"20. Neyman CARA";"20. Neyman CARA";183;211;205;6;993;7
"184";"20. Neyman CARA";"20. Neyman CARA";184;543;148;395;515;485
"185";"20. Neyman CARA";"20. Neyman CARA";185;526;141;385;515;485
"186";"20. Neyman CARA";"20. Neyman CARA";186;199;194;5;987;13
"187";"20. Neyman CARA";"20. Neyman CARA";187;208;204;4;995;5
"188";"20. Neyman CARA";"20. Neyman CARA";188;393;90;303;485;515
"189";"20. Neyman CARA";"20. Neyman CARA";189;542;160;382;516;484
"190";"20. Neyman CARA";"20. Neyman CARA";190;521;147;374;514;486
"191";"20. Neyman CARA";"20. Neyman CARA";191;213;210;3;994;6
"192";"20. Neyman CARA";"20. Neyman CARA";192;206;201;5;994;6
"193";"20. Neyman CARA";"20. Neyman CARA";193;531;162;369;516;484
"194";"20. Neyman CARA";"20. Neyman CARA";194;422;114;308;475;525
"195";"20. Neyman CARA";"20. Neyman CARA";195;403;106;297;517;483
"196";"20. Neyman CARA";"20. Neyman CARA";196;390;106;284;497;503
"197";"20. Neyman CARA";"20. Neyman CARA";197;425;107;318;493;507
"198";"20. Neyman CARA";"20. Neyman CARA";198;401;120;281;551;449
"199";"20. Neyman CARA";"20. Neyman CARA";199;344;151;193;694;306
"200";"20. Neyman CARA";"20. Neyman CARA";200;212;209;3;994;6
"201";"20. Neyman CARA";"20. Neyman CARA";201;458;122;336;524;476
"202";"20. Neyman CARA";"20. Neyman CARA";202;394;90;304;507;493
"203";"20. Neyman CARA";"20. Neyman CARA";203;249;179;70;868;132
"204";"20. Neyman CARA";"20. Neyman CARA";204;199;195;4;994;6
"205";"20. Neyman CARA";"20. Neyman CARA";205;376;83;293;500;500
"206";"20. Neyman CARA";"20. Neyman CARA";206;262;55;207;485;515
"207";"20. Neyman CARA";"20. Neyman CARA";207;511;152;359;515;485
"208";"20. Neyman CARA";"20. Neyman CARA";208;381;88;293;492;508
"209";"20. Neyman CARA";"20. Neyman CARA";209;376;117;259;540;460
"210";"20. Neyman CARA";"20. Neyman CARA";210;404;123;281;524;476
"211";"20. Neyman CARA";"20. Neyman CARA";211;233;54;179;489;511
"212";"20. Neyman CARA";"20. Neyman CARA";212;392;101;291;492;508
"213";"20. Neyman CARA";"20. Neyman CARA";213;418;109;309;509;491
"214";"20. Neyman CARA";"20. Neyman CARA";214;417;109;308;479;521
"215";"20. Neyman CARA";"20. Neyman CARA";215;402;102;300;501;499
"216";"20. Neyman CARA";"20. Neyman CARA";216;195;192;3;995;5
"217";"20. Neyman CARA";"20. Neyman CARA";217;550;162;388;514;486
"218";"20. Neyman CARA";"20. Neyman CARA";218;458;136;322;498;502
"219";"20. Neyman CARA";"20. Neyman CARA";219;407;95;312;486;514
"220";"20. Neyman CARA";"20. Neyman CARA";220;213;208;5;993;7
"221";"20. Neyman CARA";"20. Neyman CARA";221;204;199;5;993;7
"222";"20. Neyman CARA";"20. Neyman CARA";222;381;123;258;556;444
"223";"20. Neyman CARA";"20. Neyman CARA";223;216;211;5;994;6
"224";"20. Neyman CARA";"20. Neyman CARA";224;187;183;4;995;5
"225";"20. Neyman CARA";"20. Neyman CARA";225;319;120;199;676;324
"226";"20. Neyman CARA";"20. Neyman CARA";226;532;141;391;516;484
"227";"20. Neyman CARA";"20. Neyman CARA";227;203;199;4;995;5
"228";"20. Neyman CARA";"20. Neyman CARA";228;408;118;290;511;489
"229";"20. Neyman CARA";"20. Neyman CARA";229;203;198;5;994;6
"230";"20. Neyman CARA";"20. Neyman CARA";230;535;149;386;515;485
"231";"20. Neyman CARA";"20. Neyman CARA";231;213;209;4;995;5
"232";"20. Neyman CARA";"20. Neyman CARA";232;393;86;307;464;536
"233";"20. Neyman CARA";"20. Neyman CARA";233;255;47;208;486;514
"234";"20. Neyman CARA";"20. Neyman CARA";234;267;48;219;486;514
"235";"20. Neyman CARA";"20. Neyman CARA";235;528;155;373;510;490
"236";"20. Neyman CARA";"20. Neyman CARA";236;531;134;397;515;485
"237";"20. Neyman CARA";"20. Neyman CARA";237;205;197;8;990;10
"238";"20. Neyman CARA";"20. Neyman CARA";238;202;197;5;993;7
"239";"20. Neyman CARA";"20. Neyman CARA";239;522;150;372;504;496
"240";"20. Neyman CARA";"20. Neyman CARA";240;541;152;389;511;489
"241";"20. Neyman CARA";"20. Neyman CARA";241;201;196;5;994;6
"242";"20. Neyman CARA";"20. Neyman CARA";242;427;104;323;489;511
"243";"20. Neyman CARA";"20. Neyman CARA";243;391;97;294;513;487
"244";"20. Neyman CARA";"20. Neyman CARA";244;192;188;4;994;6
"245";"20. Neyman CARA";"20. Neyman CARA";245;293;161;132;776;224
"246";"20. Neyman CARA";"20. Neyman CARA";246;404;94;310;494;506
"247";"20. Neyman CARA";"20. Neyman CARA";247;383;98;285;504;496
"248";"20. Neyman CARA";"20. Neyman CARA";248;192;187;5;994;6
"249";"20. Neyman CARA";"20. Neyman CARA";249;268;52;216;484;516
"250";"20. Neyman CARA";"20. Neyman CARA";250;385;87;298;492;508
"251";"20. Neyman CARA";"20. Neyman CARA";251;398;95;303;484;516
"252";"20. Neyman CARA";"20. Neyman CARA";252;399;91;308;471;529
"253";"20. Neyman CARA";"20. Neyman CARA";253;412;105;307;486;514
"254";"20. Neyman CARA";"20. Neyman CARA";254;537;160;377;516;484
"255";"20. Neyman CARA";"20. Neyman CARA";255;410;100;310;506;494
"256";"20. Neyman CARA";"20. Neyman CARA";256;394;93;301;499;501
"257";"20. Neyman CARA";"20. Neyman CARA";257;397;118;279;538;462
"258";"20. Neyman CARA";"20. Neyman CARA";258;404;108;296;492;508
"259";"20. Neyman CARA";"20. Neyman CARA";259;414;102;312;493;507
"260";"20. Neyman CARA";"20. Neyman CARA";260;390;107;283;508;492
"261";"20. Neyman CARA";"20. Neyman CARA";261;408;91;317;481;519
"262";"20. Neyman CARA";"20. Neyman CARA";262;216;213;3;995;5
"263";"20. Neyman CARA";"20. Neyman CARA";263;208;203;5;992;8
"264";"20. Neyman CARA";"20. Neyman CARA";264;248;39;209;484;516
"265";"20. Neyman CARA";"20. Neyman CARA";265;537;164;373;514;486
"266";"20. Neyman CARA";"20. Neyman CARA";266;212;206;6;992;8
"267";"20. Neyman CARA";"20. Neyman CARA";267;189;187;2;994;6
"268";"20. Neyman CARA";"20. Neyman CARA";268;242;188;54;913;87
"269";"20. Neyman CARA";"20. Neyman CARA";269;529;149;380;515;485
"270";"20. Neyman CARA";"20. Neyman CARA";270;209;206;3;995;5
"271";"20. Neyman CARA";"20. Neyman CARA";271;279;58;221;483;517
"272";"20. Neyman CARA";"20. Neyman CARA";272;195;191;4;994;6
"273";"20. Neyman CARA";"20. Neyman CARA";273;211;206;5;994;6
"274";"20. Neyman CARA";"20. Neyman CARA";274;193;190;3;994;6
"275";"20. Neyman CARA";"20. Neyman CARA";275;328;74;254;487;513
"276";"20. Neyman CARA";"20. Neyman CARA";276;419;111;308;488;512
"277";"20. Neyman CARA";"20. Neyman CARA";277;401;89;312;484;516
"278";"20. Neyman CARA";"20. Neyman CARA";278;395;88;307;466;534
"279";"20. Neyman CARA";"20. Neyman CARA";279;382;110;272;533;467
"280";"20. Neyman CARA";"20. Neyman CARA";280;223;220;3;995;5
"281";"20. Neyman CARA";"20. Neyman CARA";281;541;160;381;523;477
"282";"20. Neyman CARA";"20. Neyman CARA";282;334;165;169;710;290
"283";"20. Neyman CARA";"20. Neyman CARA";283;222;219;3;994;6
"284";"20. Neyman CARA";"20. Neyman CARA";284;419;92;327;487;513
"285";"20. Neyman CARA";"20. Neyman CARA";285;414;110;304;501;499
"286";"20. Neyman CARA";"20. Neyman CARA";286;206;202;4;991;9
"287";"20. Neyman CARA";"20. Neyman CARA";287;399;109;290;495;505
"288";"20. Neyman CARA";"20. Neyman CARA";288;218;212;6;993;7
"289";"20. Neyman CARA";"20. Neyman CARA";289;209;201;8;991;9
"290";"20. Neyman CARA";"20. Neyman CARA";290;383;106;277;509;491
"291";"20. Neyman CARA";"20. Neyman CARA";291;427;126;301;517;483
"292";"20. Neyman CARA";"20. Neyman CARA";292;416;112;304;500;500
"293";"20. Neyman CARA";"20. Neyman CARA";293;262;44;218;484;516
"294";"20. Neyman CARA";"20. Neyman CARA";294;540;151;389;517;483
"295";"20. Neyman CARA";"20. Neyman CARA";295;519;151;368;515;485
"296";"20. Neyman CARA";"20. Neyman CARA";296;364;89;275;524;476
"297";"20. Neyman CARA";"20. Neyman CARA";297;258;42;216;485;515
"298";"20. Neyman CARA";"20. Neyman CARA";298;238;52;186;487;513
"299";"20. Neyman CARA";"20. Neyman CARA";299;283;58;225;485;515
"300";"20. Neyman CARA";"20. Neyman CARA";300;411;100;311;501;499
"301";"20. Neyman CARA";"20. Neyman CARA";301;411;78;333;461;539
"302";"20. Neyman CARA";"20. Neyman CARA";302;415;115;300;510;490
"303";"20. Neyman CARA";"20. Neyman CARA";303;202;197;5;994;6
"304";"20. Neyman CARA";"20. Neyman CARA";304;553;161;392;514;486
"305";"20. Neyman CARA";"20. Neyman CARA";305;226;206;20;969;31
"306";"20. Neyman CARA";"20. Neyman CARA";306;442;127;315;507;493
"307";"20. Neyman CARA";"20. Neyman CARA";307;520;146;374;515;485
"308";"20. Neyman CARA";"20. Neyman CARA";308;413;92;321;494;506
"309";"20. Neyman CARA";"20. Neyman CARA";309;397;100;297;495;505
"310";"20. Neyman CARA";"20. Neyman CARA";310;421;112;309;495;505
"311";"20. Neyman CARA";"20. Neyman CARA";311;374;115;259;550;450
"312";"20. Neyman CARA";"20. Neyman CARA";312;406;86;320;470;530
"313";"20. Neyman CARA";"20. Neyman CARA";313;546;168;378;515;485
"314";"20. Neyman CARA";"20. Neyman CARA";314;560;166;394;515;485
"315";"20. Neyman CARA";"20. Neyman CARA";315;220;216;4;993;7
"316";"20. Neyman CARA";"20. Neyman CARA";316;337;74;263;492;508
"317";"20. Neyman CARA";"20. Neyman CARA";317;409;109;300;494;506
"318";"20. Neyman CARA";"20. Neyman CARA";318;417;95;322;471;529
"319";"20. Neyman CARA";"20. Neyman CARA";319;544;155;389;515;485
"320";"20. Neyman CARA";"20. Neyman CARA";320;295;131;164;707;293
"321";"20. Neyman CARA";"20. Neyman CARA";321;508;156;352;518;482
"322";"20. Neyman CARA";"20. Neyman CARA";322;416;97;319;488;512
"323";"20. Neyman CARA";"20. Neyman CARA";323;215;212;3;993;7
"324";"20. Neyman CARA";"20. Neyman CARA";324;427;111;316;502;498
"325";"20. Neyman CARA";"20. Neyman CARA";325;395;106;289;496;504
"326";"20. Neyman CARA";"20. Neyman CARA";326;388;104;284;523;477
"327";"20. Neyman CARA";"20. Neyman CARA";327;376;111;265;562;438
"328";"20. Neyman CARA";"20. Neyman CARA";328;269;51;218;486;514
"329";"20. Neyman CARA";"20. Neyman CARA";329;402;107;295;492;508
"330";"20. Neyman CARA";"20. Neyman CARA";330;194;188;6;993;7
"331";"20. Neyman CARA";"20. Neyman CARA";331;528;139;389;515;485
"332";"20. Neyman CARA";"20. Neyman CARA";332;396;113;283;536;464
"333";"20. Neyman CARA";"20. Neyman CARA";333;214;209;5;994;6
"334";"20. Neyman CARA";"20. Neyman CARA";334;432;94;338;461;539
"335";"20. Neyman CARA";"20. Neyman CARA";335;319;148;171;717;283
"336";"20. Neyman CARA";"20. Neyman CARA";336;527;157;370;516;484
"337";"20. Neyman CARA";"20. Neyman CARA";337;397;89;308;484;516
"338";"20. Neyman CARA";"20. Neyman CARA";338;404;112;292;522;478
"339";"20. Neyman CARA";"20. Neyman CARA";339;412;95;317;479;521
"340";"20. Neyman CARA";"20. Neyman CARA";340;370;109;261;562;438
"341";"20. Neyman CARA";"20. Neyman CARA";341;339;87;252;487;513
"342";"20. Neyman CARA";"20. Neyman CARA";342;546;169;377;513;487
"343";"20. Neyman CARA";"20. Neyman CARA";343;208;203;5;994;6
"344";"20. Neyman CARA";"20. Neyman CARA";344;397;78;319;443;557
"345";"20. Neyman CARA";"20. Neyman CARA";345;396;110;286;529;471
"346";"20. Neyman CARA";"20. Neyman CARA";346;543;153;390;515;485
"347";"20. Neyman CARA";"20. Neyman CARA";347;392;112;280;528;472
"348";"20. Neyman CARA";"20. Neyman CARA";348;403;104;299;486;514
"349";"20. Neyman CARA";"20. Neyman CARA";349;300;181;119;789;211
"350";"20. Neyman CARA";"20. Neyman CARA";350;188;185;3;991;9
"351";"20. Neyman CARA";"20. Neyman CARA";351;385;94;291;515;485
"352";"20. Neyman CARA";"20. Neyman CARA";352;412;116;296;521;479
"353";"20. Neyman CARA";"20. Neyman CARA";353;251;52;199;485;515
"354";"20. Neyman CARA";"20. Neyman CARA";354;208;203;5;994;6
"355";"20. Neyman CARA";"20. Neyman CARA";355;529;146;383;514;486
"356";"20. Neyman CARA";"20. Neyman CARA";356;210;205;5;994;6
"357";"20. Neyman CARA";"20. Neyman CARA";357;425;110;315;489;511
"358";"20. Neyman CARA";"20. Neyman CARA";358;531;148;383;518;482
"359";"20. Neyman CARA";"20. Neyman CARA";359;527;133;394;515;485
"360";"20. Neyman CARA";"20. Neyman CARA";360;187;184;3;994;6
"361";"20. Neyman CARA";"20. Neyman CARA";361;322;110;212;644;356
"362";"20. Neyman CARA";"20. Neyman CARA";362;257;185;72;876;124
"363";"20. Neyman CARA";"20. Neyman CARA";363;523;149;374;513;487
"364";"20. Neyman CARA";"20. Neyman CARA";364;193;190;3;993;7
"365";"20. Neyman CARA";"20. Neyman CARA";365;190;185;5;993;7
"366";"20. Neyman CARA";"20. Neyman CARA";366;426;109;317;492;508
"367";"20. Neyman CARA";"20. Neyman CARA";367;202;197;5;994;6
"368";"20. Neyman CARA";"20. Neyman CARA";368;393;112;281;521;479
"369";"20. Neyman CARA";"20. Neyman CARA";369;393;99;294;514;486
"370";"20. Neyman CARA";"20. Neyman CARA";370;223;187;36;927;73
"371";"20. Neyman CARA";"20. Neyman CARA";371;214;209;5;994;6
"372";"20. Neyman CARA";"20. Neyman CARA";372;553;155;398;515;485
"373";"20. Neyman CARA";"20. Neyman CARA";373;404;101;303;471;529
"374";"20. Neyman CARA";"20. Neyman CARA";374;198;194;4;994;6
"375";"20. Neyman CARA";"20. Neyman CARA";375;199;193;6;993;7
"376";"20. Neyman CARA";"20. Neyman CARA";376;468;139;329;527;473
"377";"20. Neyman CARA";"20. Neyman CARA";377;215;211;4;994;6
"378";"20. Neyman CARA";"20. Neyman CARA";378;545;155;390;516;484
"379";"20. Neyman CARA";"20. Neyman CARA";379;211;207;4;994;6
"380";"20. Neyman CARA";"20. Neyman CARA";380;453;127;326;516;484
"381";"20. Neyman CARA";"20. Neyman CARA";381;477;133;344;524;476
"382";"20. Neyman CARA";"20. Neyman CARA";382;487;140;347;524;476
"383";"20. Neyman CARA";"20. Neyman CARA";383;467;140;327;525;475
"384";"20. Neyman CARA";"20. Neyman CARA";384;400;101;299;512;488
"385";"20. Neyman CARA";"20. Neyman CARA";385;402;76;326;465;535
"386";"20. Neyman CARA";"20. Neyman CARA";386;391;94;297;504;496
"387";"20. Neyman CARA";"20. Neyman CARA";387;189;184;5;993;7
"388";"20. Neyman CARA";"20. Neyman CARA";388;400;100;300;485;515
"389";"20. Neyman CARA";"20. Neyman CARA";389;522;138;384;516;484
"390";"20. Neyman CARA";"20. Neyman CARA";390;388;113;275;535;465
"391";"20. Neyman CARA";"20. Neyman CARA";391;545;163;382;515;485
"392";"20. Neyman CARA";"20. Neyman CARA";392;407;105;302;483;517
"393";"20. Neyman CARA";"20. Neyman CARA";393;387;105;282;498;502
"394";"20. Neyman CARA";"20. Neyman CARA";394;189;185;4;995;5
"395";"20. Neyman CARA";"20. Neyman CARA";395;214;209;5;990;10
"396";"20. Neyman CARA";"20. Neyman CARA";396;387;107;280;502;498
"397";"20. Neyman CARA";"20. Neyman CARA";397;405;106;299;499;501
"398";"20. Neyman CARA";"20. Neyman CARA";398;415;126;289;530;470
"399";"20. Neyman CARA";"20. Neyman CARA";399;396;93;303;480;520
"400";"20. Neyman CARA";"20. Neyman CARA";400;405;103;302;495;505
"401";"20. Neyman CARA";"20. Neyman CARA";401;531;152;379;512;488
"402";"20. Neyman CARA";"20. Neyman CARA";402;427;126;301;505;495
"403";"20. Neyman CARA";"20. Neyman CARA";403;424;110;314;499;501
"404";"20. Neyman CARA";"20. Neyman CARA";404;211;204;7;992;8
"405";"20. Neyman CARA";"20. Neyman CARA";405;259;53;206;486;514
"406";"20. Neyman CARA";"20. Neyman CARA";406;404;115;289;523;477
"407";"20. Neyman CARA";"20. Neyman CARA";407;193;190;3;995;5
"408";"20. Neyman CARA";"20. Neyman CARA";408;216;211;5;993;7
"409";"20. Neyman CARA";"20. Neyman CARA";409;414;120;294;510;490
"410";"20. Neyman CARA";"20. Neyman CARA";410;539;142;397;514;486
"411";"20. Neyman CARA";"20. Neyman CARA";411;538;150;388;517;483
"412";"20. Neyman CARA";"20. Neyman CARA";412;197;194;3;995;5
"413";"20. Neyman CARA";"20. Neyman CARA";413;377;93;284;514;486
"414";"20. Neyman CARA";"20. Neyman CARA";414;403;105;298;500;500
"415";"20. Neyman CARA";"20. Neyman CARA";415;207;201;6;993;7
"416";"20. Neyman CARA";"20. Neyman CARA";416;555;155;400;513;487
"417";"20. Neyman CARA";"20. Neyman CARA";417;397;99;298;468;532
"418";"20. Neyman CARA";"20. Neyman CARA";418;268;65;203;487;513
"419";"20. Neyman CARA";"20. Neyman CARA";419;447;120;327;532;468
"420";"20. Neyman CARA";"20. Neyman CARA";420;396;120;276;541;459
"421";"20. Neyman CARA";"20. Neyman CARA";421;199;195;4;995;5
"422";"20. Neyman CARA";"20. Neyman CARA";422;380;91;289;513;487
"423";"20. Neyman CARA";"20. Neyman CARA";423;530;155;375;511;489
"424";"20. Neyman CARA";"20. Neyman CARA";424;372;98;274;528;472
"425";"20. Neyman CARA";"20. Neyman CARA";425;392;91;301;494;506
"426";"20. Neyman CARA";"20. Neyman CARA";426;427;89;338;469;531
"427";"20. Neyman CARA";"20. Neyman CARA";427;197;192;5;991;9
"428";"20. Neyman CARA";"20. Neyman CARA";428;385;116;269;549;451
"429";"20. Neyman CARA";"20. Neyman CARA";429;279;58;221;485;515
"430";"20. Neyman CARA";"20. Neyman CARA";430;549;162;387;516;484
"431";"20. Neyman CARA";"20. Neyman CARA";431;325;65;260;486;514
"432";"20. Neyman CARA";"20. Neyman CARA";432;385;91;294;474;526
"433";"20. Neyman CARA";"20. Neyman CARA";433;221;215;6;993;7
"434";"20. Neyman CARA";"20. Neyman CARA";434;420;122;298;509;491
"435";"20. Neyman CARA";"20. Neyman CARA";435;418;107;311;480;520
"436";"20. Neyman CARA";"20. Neyman CARA";436;526;151;375;515;485
"437";"20. Neyman CARA";"20. Neyman CARA";437;402;84;318;468;532
"438";"20. Neyman CARA";"20. Neyman CARA";438;526;142;384;522;478
"439";"20. Neyman CARA";"20. Neyman CARA";439;399;107;292;510;490
"440";"20. Neyman CARA";"20. Neyman CARA";440;266;48;218;487;513
"441";"20. Neyman CARA";"20. Neyman CARA";441;211;208;3;995;5
"442";"20. Neyman CARA";"20. Neyman CARA";442;409;114;295;522;478
"443";"20. Neyman CARA";"20. Neyman CARA";443;549;161;388;515;485
"444";"20. Neyman CARA";"20. Neyman CARA";444;394;122;272;530;470
"445";"20. Neyman CARA";"20. Neyman CARA";445;548;158;390;518;482
"446";"20. Neyman CARA";"20. Neyman CARA";446;212;207;5;994;6
"447";"20. Neyman CARA";"20. Neyman CARA";447;395;110;285;530;470
"448";"20. Neyman CARA";"20. Neyman CARA";448;212;204;8;991;9
"449";"20. Neyman CARA";"20. Neyman CARA";449;390;100;290;515;485
"450";"20. Neyman CARA";"20. Neyman CARA";450;386;103;283;480;520
"451";"20. Neyman CARA";"20. Neyman CARA";451;224;193;31;941;59
"452";"20. Neyman CARA";"20. Neyman CARA";452;417;103;314;493;507
"453";"20. Neyman CARA";"20. Neyman CARA";453;401;90;311;483;517
"454";"20. Neyman CARA";"20. Neyman CARA";454;400;114;286;502;498
"455";"20. Neyman CARA";"20. Neyman CARA";455;217;212;5;993;7
"456";"20. Neyman CARA";"20. Neyman CARA";456;213;210;3;994;6
"457";"20. Neyman CARA";"20. Neyman CARA";457;330;176;154;741;259
"458";"20. Neyman CARA";"20. Neyman CARA";458;391;90;301;475;525
"459";"20. Neyman CARA";"20. Neyman CARA";459;183;179;4;995;5
"460";"20. Neyman CARA";"20. Neyman CARA";460;391;104;287;524;476
"461";"20. Neyman CARA";"20. Neyman CARA";461;273;56;217;484;516
"462";"20. Neyman CARA";"20. Neyman CARA";462;396;95;301;510;490
"463";"20. Neyman CARA";"20. Neyman CARA";463;387;107;280;518;482
"464";"20. Neyman CARA";"20. Neyman CARA";464;386;95;291;486;514
"465";"20. Neyman CARA";"20. Neyman CARA";465;404;102;302;506;494
"466";"20. Neyman CARA";"20. Neyman CARA";466;199;195;4;994;6
"467";"20. Neyman CARA";"20. Neyman CARA";467;400;107;293;488;512
"468";"20. Neyman CARA";"20. Neyman CARA";468;214;211;3;995;5
"469";"20. Neyman CARA";"20. Neyman CARA";469;199;191;8;991;9
"470";"20. Neyman CARA";"20. Neyman CARA";470;205;200;5;994;6
"471";"20. Neyman CARA";"20. Neyman CARA";471;200;195;5;992;8
"472";"20. Neyman CARA";"20. Neyman CARA";472;220;215;5;994;6
"473";"20. Neyman CARA";"20. Neyman CARA";473;278;56;222;486;514
"474";"20. Neyman CARA";"20. Neyman CARA";474;536;154;382;516;484
"475";"20. Neyman CARA";"20. Neyman CARA";475;411;110;301;498;502
"476";"20. Neyman CARA";"20. Neyman CARA";476;519;134;385;512;488
"477";"20. Neyman CARA";"20. Neyman CARA";477;391;91;300;480;520
"478";"20. Neyman CARA";"20. Neyman CARA";478;379;90;289;501;499
"479";"20. Neyman CARA";"20. Neyman CARA";479;227;219;8;987;13
"480";"20. Neyman CARA";"20. Neyman CARA";480;367;127;240;621;379
"481";"20. Neyman CARA";"20. Neyman CARA";481;416;112;304;500;500
"482";"20. Neyman CARA";"20. Neyman CARA";482;397;106;291;528;472
"483";"20. Neyman CARA";"20. Neyman CARA";483;393;86;307;475;525
"484";"20. Neyman CARA";"20. Neyman CARA";484;404;94;310;477;523
"485";"20. Neyman CARA";"20. Neyman CARA";485;381;101;280;483;517
"486";"20. Neyman CARA";"20. Neyman CARA";486;498;152;346;535;465
"487";"20. Neyman CARA";"20. Neyman CARA";487;529;142;387;515;485
"488";"20. Neyman CARA";"20. Neyman CARA";488;265;48;217;485;515
"489";"20. Neyman CARA";"20. Neyman CARA";489;544;151;393;514;486
"490";"20. Neyman CARA";"20. Neyman CARA";490;572;167;405;515;485
"491";"20. Neyman CARA";"20. Neyman CARA";491;395;109;286;510;490
"492";"20. Neyman CARA";"20. Neyman CARA";492;438;119;319;494;506
"493";"20. Neyman CARA";"20. Neyman CARA";493;410;103;307;506;494
"494";"20. Neyman CARA";"20. Neyman CARA";494;376;93;283;512;488
"495";"20. Neyman CARA";"20. Neyman CARA";495;524;145;379;515;485
"496";"20. Neyman CARA";"20. Neyman CARA";496;411;102;309;482;518
"497";"20. Neyman CARA";"20. Neyman CARA";497;212;208;4;994;6
"498";"20. Neyman CARA";"20. Neyman CARA";498;524;144;380;514;486
"499";"20. Neyman CARA";"20. Neyman CARA";499;337;133;204;673;327
"500";"20. Neyman CARA";"20. Neyman CARA";500;395;93;302;467;533
"501";"20. Neyman CARA";"20. Neyman CARA";501;560;161;399;514;486
"502";"20. Neyman CARA";"20. Neyman CARA";502;390;107;283;511;489
"503";"20. Neyman CARA";"20. Neyman CARA";503;424;97;327;476;524
"504";"20. Neyman CARA";"20. Neyman CARA";504;207;203;4;994;6
"505";"20. Neyman CARA";"20. Neyman CARA";505;224;220;4;994;6
"506";"20. Neyman CARA";"20. Neyman CARA";506;423;115;308;517;483
"507";"20. Neyman CARA";"20. Neyman CARA";507;403;95;308;500;500
"508";"20. Neyman CARA";"20. Neyman CARA";508;405;120;285;519;481
"509";"20. Neyman CARA";"20. Neyman CARA";509;522;130;392;515;485
"510";"20. Neyman CARA";"20. Neyman CARA";510;259;56;203;489;511
"511";"20. Neyman CARA";"20. Neyman CARA";511;399;126;273;548;452
"512";"20. Neyman CARA";"20. Neyman CARA";512;401;110;291;507;493
"513";"20. Neyman CARA";"20. Neyman CARA";513;218;213;5;994;6
"514";"20. Neyman CARA";"20. Neyman CARA";514;394;84;310;490;510
"515";"20. Neyman CARA";"20. Neyman CARA";515;527;146;381;513;487
"516";"20. Neyman CARA";"20. Neyman CARA";516;213;208;5;994;6
"517";"20. Neyman CARA";"20. Neyman CARA";517;408;109;299;481;519
"518";"20. Neyman CARA";"20. Neyman CARA";518;555;159;396;515;485
"519";"20. Neyman CARA";"20. Neyman CARA";519;391;106;285;511;489
"520";"20. Neyman CARA";"20. Neyman CARA";520;354;128;226;624;376
"521";"20. Neyman CARA";"20. Neyman CARA";521;568;168;400;514;486
"522";"20. Neyman CARA";"20. Neyman CARA";522;379;95;284;508;492
"523";"20. Neyman CARA";"20. Neyman CARA";523;541;155;386;514;486
"524";"20. Neyman CARA";"20. Neyman CARA";524;262;53;209;487;513
"525";"20. Neyman CARA";"20. Neyman CARA";525;206;204;2;993;7
"526";"20. Neyman CARA";"20. Neyman CARA";526;526;136;390;514;486
"527";"20. Neyman CARA";"20. Neyman CARA";527;386;83;303;483;517
"528";"20. Neyman CARA";"20. Neyman CARA";528;212;208;4;995;5
"529";"20. Neyman CARA";"20. Neyman CARA";529;396;89;307;490;510
"530";"20. Neyman CARA";"20. Neyman CARA";530;395;98;297;475;525
"531";"20. Neyman CARA";"20. Neyman CARA";531;263;46;217;486;514
"532";"20. Neyman CARA";"20. Neyman CARA";532;501;138;363;505;495
"533";"20. Neyman CARA";"20. Neyman CARA";533;382;114;268;543;457
"534";"20. Neyman CARA";"20. Neyman CARA";534;255;46;209;485;515
"535";"20. Neyman CARA";"20. Neyman CARA";535;494;138;356;515;485
"536";"20. Neyman CARA";"20. Neyman CARA";536;394;104;290;497;503
"537";"20. Neyman CARA";"20. Neyman CARA";537;373;76;297;469;531
"538";"20. Neyman CARA";"20. Neyman CARA";538;520;144;376;515;485
"539";"20. Neyman CARA";"20. Neyman CARA";539;504;132;372;493;507
"540";"20. Neyman CARA";"20. Neyman CARA";540;211;208;3;995;5
"541";"20. Neyman CARA";"20. Neyman CARA";541;408;107;301;479;521
"542";"20. Neyman CARA";"20. Neyman CARA";542;420;114;306;527;473
"543";"20. Neyman CARA";"20. Neyman CARA";543;402;89;313;484;516
"544";"20. Neyman CARA";"20. Neyman CARA";544;190;187;3;995;5
"545";"20. Neyman CARA";"20. Neyman CARA";545;536;154;382;515;485
"546";"20. Neyman CARA";"20. Neyman CARA";546;207;202;5;993;7
"547";"20. Neyman CARA";"20. Neyman CARA";547;271;60;211;485;515
"548";"20. Neyman CARA";"20. Neyman CARA";548;407;108;299;489;511
"549";"20. Neyman CARA";"20. Neyman CARA";549;239;234;5;994;6
"550";"20. Neyman CARA";"20. Neyman CARA";550;536;156;380;515;485
"551";"20. Neyman CARA";"20. Neyman CARA";551;527;136;391;515;485
"552";"20. Neyman CARA";"20. Neyman CARA";552;221;163;58;899;101
"553";"20. Neyman CARA";"20. Neyman CARA";553;215;209;6;993;7
"554";"20. Neyman CARA";"20. Neyman CARA";554;404;122;282;512;488
"555";"20. Neyman CARA";"20. Neyman CARA";555;230;35;195;485;515
"556";"20. Neyman CARA";"20. Neyman CARA";556;279;61;218;488;512
"557";"20. Neyman CARA";"20. Neyman CARA";557;545;160;385;519;481
"558";"20. Neyman CARA";"20. Neyman CARA";558;397;95;302;493;507
"559";"20. Neyman CARA";"20. Neyman CARA";559;388;83;305;491;509
"560";"20. Neyman CARA";"20. Neyman CARA";560;420;98;322;480;520
"561";"20. Neyman CARA";"20. Neyman CARA";561;222;218;4;994;6
"562";"20. Neyman CARA";"20. Neyman CARA";562;554;158;396;515;485
"563";"20. Neyman CARA";"20. Neyman CARA";563;558;172;386;516;484
"564";"20. Neyman CARA";"20. Neyman CARA";564;214;210;4;995;5
"565";"20. Neyman CARA";"20. Neyman CARA";565;390;108;282;510;490
"566";"20. Neyman CARA";"20. Neyman CARA";566;239;46;193;485;515
"567";"20. Neyman CARA";"20. Neyman CARA";567;410;97;313;476;524
"568";"20. Neyman CARA";"20. Neyman CARA";568;404;102;302;501;499
"569";"20. Neyman CARA";"20. Neyman CARA";569;418;102;316;480;520
"570";"20. Neyman CARA";"20. Neyman CARA";570;541;145;396;514;486
"571";"20. Neyman CARA";"20. Neyman CARA";571;417;110;307;479;521
"572";"20. Neyman CARA";"20. Neyman CARA";572;359;82;277;532;468
"573";"20. Neyman CARA";"20. Neyman CARA";573;414;117;297;525;475
"574";"20. Neyman CARA";"20. Neyman CARA";574;400;104;296;491;509
"575";"20. Neyman CARA";"20. Neyman CARA";575;420;96;324;477;523
"576";"20. Neyman CARA";"20. Neyman CARA";576;490;149;341;538;462
"577";"20. Neyman CARA";"20. Neyman CARA";577;337;80;257;486;514
"578";"20. Neyman CARA";"20. Neyman CARA";578;191;188;3;995;5
"579";"20. Neyman CARA";"20. Neyman CARA";579;515;137;378;515;485
"580";"20. Neyman CARA";"20. Neyman CARA";580;308;138;170;724;276
"581";"20. Neyman CARA";"20. Neyman CARA";581;398;111;287;522;478
"582";"20. Neyman CARA";"20. Neyman CARA";582;200;196;4;992;8
"583";"20. Neyman CARA";"20. Neyman CARA";583;209;203;6;993;7
"584";"20. Neyman CARA";"20. Neyman CARA";584;547;160;387;514;486
"585";"20. Neyman CARA";"20. Neyman CARA";585;397;98;299;512;488
"586";"20. Neyman CARA";"20. Neyman CARA";586;403;113;290;512;488
"587";"20. Neyman CARA";"20. Neyman CARA";587;228;223;5;993;7
"588";"20. Neyman CARA";"20. Neyman CARA";588;183;180;3;994;6
"589";"20. Neyman CARA";"20. Neyman CARA";589;206;202;4;995;5
"590";"20. Neyman CARA";"20. Neyman CARA";590;526;150;376;516;484
"591";"20. Neyman CARA";"20. Neyman CARA";591;205;202;3;995;5
"592";"20. Neyman CARA";"20. Neyman CARA";592;394;124;270;537;463
"593";"20. Neyman CARA";"20. Neyman CARA";593;255;175;80;878;122
"594";"20. Neyman CARA";"20. Neyman CARA";594;337;142;195;668;332
"595";"20. Neyman CARA";"20. Neyman CARA";595;205;201;4;993;7
"596";"20. Neyman CARA";"20. Neyman CARA";596;560;165;395;514;486
"597";"20. Neyman CARA";"20. Neyman CARA";597;189;185;4;995;5
"598";"20. Neyman CARA";"20. Neyman CARA";598;528;140;388;513;487
"599";"20. Neyman CARA";"20. Neyman CARA";599;195;191;4;989;11
"600";"20. Neyman CARA";"20. Neyman CARA";600;529;147;382;519;481
"601";"20. Neyman CARA";"20. Neyman CARA";601;414;99;315;495;505
"602";"20. Neyman CARA";"20. Neyman CARA";602;476;136;340;528;472
"603";"20. Neyman CARA";"20. Neyman CARA";603;517;150;367;514;486
"604";"20. Neyman CARA";"20. Neyman CARA";604;263;56;207;485;515
"605";"20. Neyman CARA";"20. Neyman CARA";605;401;81;320;459;541
"606";"20. Neyman CARA";"20. Neyman CARA";606;241;149;92;841;159
"607";"20. Neyman CARA";"20. Neyman CARA";607;453;118;335;517;483
"608";"20. Neyman CARA";"20. Neyman CARA";608;400;113;287;497;503
"609";"20. Neyman CARA";"20. Neyman CARA";609;456;127;329;508;492
"610";"20. Neyman CARA";"20. Neyman CARA";610;377;98;279;509;491
"611";"20. Neyman CARA";"20. Neyman CARA";611;404;124;280;534;466
"612";"20. Neyman CARA";"20. Neyman CARA";612;208;203;5;994;6
"613";"20. Neyman CARA";"20. Neyman CARA";613;218;214;4;994;6
"614";"20. Neyman CARA";"20. Neyman CARA";614;417;109;308;502;498
"615";"20. Neyman CARA";"20. Neyman CARA";615;543;154;389;515;485
"616";"20. Neyman CARA";"20. Neyman CARA";616;213;208;5;994;6
"617";"20. Neyman CARA";"20. Neyman CARA";617;534;138;396;514;486
"618";"20. Neyman CARA";"20. Neyman CARA";618;532;145;387;514;486
"619";"20. Neyman CARA";"20. Neyman CARA";619;517;154;363;513;487
"620";"20. Neyman CARA";"20. Neyman CARA";620;194;190;4;995;5
"621";"20. Neyman CARA";"20. Neyman CARA";621;411;85;326;477;523
"622";"20. Neyman CARA";"20. Neyman CARA";622;245;200;45;924;76
"623";"20. Neyman CARA";"20. Neyman CARA";623;407;111;296;522;478
"624";"20. Neyman CARA";"20. Neyman CARA";624;381;97;284;521;479
"625";"20. Neyman CARA";"20. Neyman CARA";625;210;206;4;994;6
"626";"20. Neyman CARA";"20. Neyman CARA";626;411;125;286;507;493
"627";"20. Neyman CARA";"20. Neyman CARA";627;403;104;299;514;486
"628";"20. Neyman CARA";"20. Neyman CARA";628;396;101;295;499;501
"629";"20. Neyman CARA";"20. Neyman CARA";629;390;103;287;517;483
"630";"20. Neyman CARA";"20. Neyman CARA";630;571;164;407;515;485
"631";"20. Neyman CARA";"20. Neyman CARA";631;400;104;296;503;497
"632";"20. Neyman CARA";"20. Neyman CARA";632;396;109;287;498;502
"633";"20. Neyman CARA";"20. Neyman CARA";633;388;91;297;497;503
"634";"20. Neyman CARA";"20. Neyman CARA";634;431;107;324;495;505
"635";"20. Neyman CARA";"20. Neyman CARA";635;230;224;6;993;7
"636";"20. Neyman CARA";"20. Neyman CARA";636;398;105;293;503;497
"637";"20. Neyman CARA";"20. Neyman CARA";637;383;105;278;506;494
"638";"20. Neyman CARA";"20. Neyman CARA";638;338;146;192;681;319
"639";"20. Neyman CARA";"20. Neyman CARA";639;221;216;5;994;6
"640";"20. Neyman CARA";"20. Neyman CARA";640;414;104;310;509;491
"641";"20. Neyman CARA";"20. Neyman CARA";641;560;164;396;519;481
"642";"20. Neyman CARA";"20. Neyman CARA";642;413;95;318;474;526
"643";"20. Neyman CARA";"20. Neyman CARA";643;189;186;3;994;6
"644";"20. Neyman CARA";"20. Neyman CARA";644;408;99;309;511;489
"645";"20. Neyman CARA";"20. Neyman CARA";645;531;144;387;514;486
"646";"20. Neyman CARA";"20. Neyman CARA";646;391;99;292;501;499
"647";"20. Neyman CARA";"20. Neyman CARA";647;431;130;301;544;456
"648";"20. Neyman CARA";"20. Neyman CARA";648;539;150;389;516;484
"649";"20. Neyman CARA";"20. Neyman CARA";649;496;157;339;520;480
"650";"20. Neyman CARA";"20. Neyman CARA";650;224;220;4;994;6
"651";"20. Neyman CARA";"20. Neyman CARA";651;406;101;305;505;495
"652";"20. Neyman CARA";"20. Neyman CARA";652;407;99;308;489;511
"653";"20. Neyman CARA";"20. Neyman CARA";653;245;39;206;483;517
"654";"20. Neyman CARA";"20. Neyman CARA";654;543;150;393;516;484
"655";"20. Neyman CARA";"20. Neyman CARA";655;399;101;298;506;494
"656";"20. Neyman CARA";"20. Neyman CARA";656;507;134;373;516;484
"657";"20. Neyman CARA";"20. Neyman CARA";657;547;153;394;512;488
"658";"20. Neyman CARA";"20. Neyman CARA";658;213;208;5;993;7
"659";"20. Neyman CARA";"20. Neyman CARA";659;400;95;305;483;517
"660";"20. Neyman CARA";"20. Neyman CARA";660;451;117;334;527;473
"661";"20. Neyman CARA";"20. Neyman CARA";661;554;154;400;514;486
"662";"20. Neyman CARA";"20. Neyman CARA";662;391;101;290;517;483
"663";"20. Neyman CARA";"20. Neyman CARA";663;430;97;333;465;535
"664";"20. Neyman CARA";"20. Neyman CARA";664;198;194;4;995;5
"665";"20. Neyman CARA";"20. Neyman CARA";665;473;116;357;486;514
"666";"20. Neyman CARA";"20. Neyman CARA";666;214;211;3;995;5
"667";"20. Neyman CARA";"20. Neyman CARA";667;287;185;102;827;173
"668";"20. Neyman CARA";"20. Neyman CARA";668;406;95;311;504;496
"669";"20. Neyman CARA";"20. Neyman CARA";669;387;77;310;479;521
"670";"20. Neyman CARA";"20. Neyman CARA";670;382;97;285;528;472
"671";"20. Neyman CARA";"20. Neyman CARA";671;382;103;279;522;478
"672";"20. Neyman CARA";"20. Neyman CARA";672;204;202;2;995;5
"673";"20. Neyman CARA";"20. Neyman CARA";673;197;193;4;994;6
"674";"20. Neyman CARA";"20. Neyman CARA";674;393;111;282;523;477
"675";"20. Neyman CARA";"20. Neyman CARA";675;214;210;4;995;5
"676";"20. Neyman CARA";"20. Neyman CARA";676;403;102;301;478;522
"677";"20. Neyman CARA";"20. Neyman CARA";677;205;197;8;990;10
"678";"20. Neyman CARA";"20. Neyman CARA";678;212;208;4;995;5
"679";"20. Neyman CARA";"20. Neyman CARA";679;536;139;397;518;482
"680";"20. Neyman CARA";"20. Neyman CARA";680;557;178;379;514;486
"681";"20. Neyman CARA";"20. Neyman CARA";681;209;204;5;991;9
"682";"20. Neyman CARA";"20. Neyman CARA";682;193;189;4;995;5
"683";"20. Neyman CARA";"20. Neyman CARA";683;281;53;228;487;513
"684";"20. Neyman CARA";"20. Neyman CARA";684;212;210;2;995;5
"685";"20. Neyman CARA";"20. Neyman CARA";685;216;212;4;995;5
"686";"20. Neyman CARA";"20. Neyman CARA";686;401;109;292;519;481
"687";"20. Neyman CARA";"20. Neyman CARA";687;203;195;8;986;14
"688";"20. Neyman CARA";"20. Neyman CARA";688;383;102;281;486;514
"689";"20. Neyman CARA";"20. Neyman CARA";689;389;103;286;515;485
"690";"20. Neyman CARA";"20. Neyman CARA";690;266;55;211;485;515
"691";"20. Neyman CARA";"20. Neyman CARA";691;290;47;243;474;526
"692";"20. Neyman CARA";"20. Neyman CARA";692;521;133;388;514;486
"693";"20. Neyman CARA";"20. Neyman CARA";693;571;7;564;66;934
"694";"20. Neyman CARA";"20. Neyman CARA";694;527;155;372;514;486
"695";"20. Neyman CARA";"20. Neyman CARA";695;226;222;4;993;7
"696";"20. Neyman CARA";"20. Neyman CARA";696;410;115;295;505;495
"697";"20. Neyman CARA";"20. Neyman CARA";697;512;141;371;515;485
"698";"20. Neyman CARA";"20. Neyman CARA";698;228;225;3;994;6
"699";"20. Neyman CARA";"20. Neyman CARA";699;383;98;285;481;519
"700";"20. Neyman CARA";"20. Neyman CARA";700;185;183;2;995;5
"701";"20. Neyman CARA";"20. Neyman CARA";701;407;98;309;496;504
"702";"20. Neyman CARA";"20. Neyman CARA";702;417;96;321;468;532
"703";"20. Neyman CARA";"20. Neyman CARA";703;204;200;4;995;5
"704";"20. Neyman CARA";"20. Neyman CARA";704;478;134;344;524;476
"705";"20. Neyman CARA";"20. Neyman CARA";705;391;103;288;516;484
"706";"20. Neyman CARA";"20. Neyman CARA";706;392;101;291;501;499
"707";"20. Neyman CARA";"20. Neyman CARA";707;442;124;318;488;512
"708";"20. Neyman CARA";"20. Neyman CARA";708;260;51;209;489;511
"709";"20. Neyman CARA";"20. Neyman CARA";709;378;105;273;510;490
"710";"20. Neyman CARA";"20. Neyman CARA";710;393;106;287;525;475
"711";"20. Neyman CARA";"20. Neyman CARA";711;547;156;391;516;484
"712";"20. Neyman CARA";"20. Neyman CARA";712;215;212;3;994;6
"713";"20. Neyman CARA";"20. Neyman CARA";713;195;191;4;995;5
"714";"20. Neyman CARA";"20. Neyman CARA";714;391;96;295;492;508
"715";"20. Neyman CARA";"20. Neyman CARA";715;551;179;372;516;484
"716";"20. Neyman CARA";"20. Neyman CARA";716;206;203;3;995;5
"717";"20. Neyman CARA";"20. Neyman CARA";717;220;215;5;994;6
"718";"20. Neyman CARA";"20. Neyman CARA";718;206;202;4;995;5
"719";"20. Neyman CARA";"20. Neyman CARA";719;233;228;5;993;7
"720";"20. Neyman CARA";"20. Neyman CARA";720;202;197;5;994;6
"721";"20. Neyman CARA";"20. Neyman CARA";721;401;100;301;494;506
"722";"20. Neyman CARA";"20. Neyman CARA";722;398;98;300;493;507
"723";"20. Neyman CARA";"20. Neyman CARA";723;468;127;341;516;484
"724";"20. Neyman CARA";"20. Neyman CARA";724;269;49;220;487;513
"725";"20. Neyman CARA";"20. Neyman CARA";725;233;229;4;993;7
"726";"20. Neyman CARA";"20. Neyman CARA";726;208;205;3;994;6
"727";"20. Neyman CARA";"20. Neyman CARA";727;383;98;285;519;481
"728";"20. Neyman CARA";"20. Neyman CARA";728;549;156;393;514;486
"729";"20. Neyman CARA";"20. Neyman CARA";729;411;95;316;499;501
"730";"20. Neyman CARA";"20. Neyman CARA";730;383;102;281;503;497
"731";"20. Neyman CARA";"20. Neyman CARA";731;416;101;315;488;512
"732";"20. Neyman CARA";"20. Neyman CARA";732;411;111;300;518;482
"733";"20. Neyman CARA";"20. Neyman CARA";733;210;207;3;995;5
"734";"20. Neyman CARA";"20. Neyman CARA";734;417;98;319;466;534
"735";"20. Neyman CARA";"20. Neyman CARA";735;390;111;279;509;491
"736";"20. Neyman CARA";"20. Neyman CARA";736;374;88;286;490;510
"737";"20. Neyman CARA";"20. Neyman CARA";737;381;112;269;533;467
"738";"20. Neyman CARA";"20. Neyman CARA";738;214;211;3;995;5
"739";"20. Neyman CARA";"20. Neyman CARA";739;382;94;288;499;501
"740";"20. Neyman CARA";"20. Neyman CARA";740;204;200;4;994;6
"741";"20. Neyman CARA";"20. Neyman CARA";741;188;186;2;995;5
"742";"20. Neyman CARA";"20. Neyman CARA";742;388;91;297;512;488
"743";"20. Neyman CARA";"20. Neyman CARA";743;427;97;330;469;531
"744";"20. Neyman CARA";"20. Neyman CARA";744;401;113;288;519;481
"745";"20. Neyman CARA";"20. Neyman CARA";745;249;42;207;485;515
"746";"20. Neyman CARA";"20. Neyman CARA";746;560;171;389;515;485
"747";"20. Neyman CARA";"20. Neyman CARA";747;429;109;320;516;484
"748";"20. Neyman CARA";"20. Neyman CARA";748;216;212;4;993;7
"749";"20. Neyman CARA";"20. Neyman CARA";749;216;200;16;973;27
"750";"20. Neyman CARA";"20. Neyman CARA";750;398;112;286;489;511
"751";"20. Neyman CARA";"20. Neyman CARA";751;399;93;306;464;536
"752";"20. Neyman CARA";"20. Neyman CARA";752;400;110;290;528;472
"753";"20. Neyman CARA";"20. Neyman CARA";753;235;35;200;484;516
"754";"20. Neyman CARA";"20. Neyman CARA";754;382;91;291;490;510
"755";"20. Neyman CARA";"20. Neyman CARA";755;406;119;287;520;480
"756";"20. Neyman CARA";"20. Neyman CARA";756;378;116;262;551;449
"757";"20. Neyman CARA";"20. Neyman CARA";757;401;127;274;564;436
"758";"20. Neyman CARA";"20. Neyman CARA";758;388;106;282;532;468
"759";"20. Neyman CARA";"20. Neyman CARA";759;398;103;295;502;498
"760";"20. Neyman CARA";"20. Neyman CARA";760;411;90;321;471;529
"761";"20. Neyman CARA";"20. Neyman CARA";761;286;52;234;486;514
"762";"20. Neyman CARA";"20. Neyman CARA";762;193;188;5;993;7
"763";"20. Neyman CARA";"20. Neyman CARA";763;211;206;5;993;7
"764";"20. Neyman CARA";"20. Neyman CARA";764;203;200;3;995;5
"765";"20. Neyman CARA";"20. Neyman CARA";765;238;182;56;903;97
"766";"20. Neyman CARA";"20. Neyman CARA";766;537;150;387;514;486
"767";"20. Neyman CARA";"20. Neyman CARA";767;553;159;394;514;486
"768";"20. Neyman CARA";"20. Neyman CARA";768;380;96;284;487;513
"769";"20. Neyman CARA";"20. Neyman CARA";769;549;169;380;515;485
"770";"20. Neyman CARA";"20. Neyman CARA";770;188;182;6;993;7
"771";"20. Neyman CARA";"20. Neyman CARA";771;374;117;257;551;449
"772";"20. Neyman CARA";"20. Neyman CARA";772;416;106;310;486;514
"773";"20. Neyman CARA";"20. Neyman CARA";773;403;100;303;459;541
"774";"20. Neyman CARA";"20. Neyman CARA";774;398;104;294;488;512
"775";"20. Neyman CARA";"20. Neyman CARA";775;561;164;397;515;485
"776";"20. Neyman CARA";"20. Neyman CARA";776;551;154;397;516;484
"777";"20. Neyman CARA";"20. Neyman CARA";777;248;43;205;484;516
"778";"20. Neyman CARA";"20. Neyman CARA";778;393;109;284;489;511
"779";"20. Neyman CARA";"20. Neyman CARA";779;519;138;381;514;486
"780";"20. Neyman CARA";"20. Neyman CARA";780;216;211;5;992;8
"781";"20. Neyman CARA";"20. Neyman CARA";781;257;64;193;489;511
"782";"20. Neyman CARA";"20. Neyman CARA";782;561;160;401;515;485
"783";"20. Neyman CARA";"20. Neyman CARA";783;402;113;289;505;495
"784";"20. Neyman CARA";"20. Neyman CARA";784;259;51;208;486;514
"785";"20. Neyman CARA";"20. Neyman CARA";785;394;118;276;536;464
"786";"20. Neyman CARA";"20. Neyman CARA";786;569;178;391;515;485
"787";"20. Neyman CARA";"20. Neyman CARA";787;224;218;6;993;7
"788";"20. Neyman CARA";"20. Neyman CARA";788;491;129;362;509;491
"789";"20. Neyman CARA";"20. Neyman CARA";789;196;191;5;994;6
"790";"20. Neyman CARA";"20. Neyman CARA";790;391;110;281;521;479
"791";"20. Neyman CARA";"20. Neyman CARA";791;199;195;4;994;6
"792";"20. Neyman CARA";"20. Neyman CARA";792;306;165;141;748;252
"793";"20. Neyman CARA";"20. Neyman CARA";793;206;201;5;991;9
"794";"20. Neyman CARA";"20. Neyman CARA";794;395;95;300;502;498
"795";"20. Neyman CARA";"20. Neyman CARA";795;215;211;4;992;8
"796";"20. Neyman CARA";"20. Neyman CARA";796;210;204;6;991;9
"797";"20. Neyman CARA";"20. Neyman CARA";797;217;213;4;994;6
"798";"20. Neyman CARA";"20. Neyman CARA";798;201;197;4;994;6
"799";"20. Neyman CARA";"20. Neyman CARA";799;228;223;5;994;6
"800";"20. Neyman CARA";"20. Neyman CARA";800;546;153;393;518;482
"801";"20. Neyman CARA";"20. Neyman CARA";801;207;202;5;993;7
"802";"20. Neyman CARA";"20. Neyman CARA";802;384;106;278;522;478
"803";"20. Neyman CARA";"20. Neyman CARA";803;549;154;395;516;484
"804";"20. Neyman CARA";"20. Neyman CARA";804;568;179;389;515;485
"805";"20. Neyman CARA";"20. Neyman CARA";805;393;100;293;507;493
"806";"20. Neyman CARA";"20. Neyman CARA";806;393;88;305;484;516
"807";"20. Neyman CARA";"20. Neyman CARA";807;221;216;5;993;7
"808";"20. Neyman CARA";"20. Neyman CARA";808;380;86;294;521;479
"809";"20. Neyman CARA";"20. Neyman CARA";809;416;101;315;490;510
"810";"20. Neyman CARA";"20. Neyman CARA";810;523;142;381;529;471
"811";"20. Neyman CARA";"20. Neyman CARA";811;518;141;377;512;488
"812";"20. Neyman CARA";"20. Neyman CARA";812;405;95;310;475;525
"813";"20. Neyman CARA";"20. Neyman CARA";813;262;59;203;485;515
"814";"20. Neyman CARA";"20. Neyman CARA";814;255;42;213;484;516
"815";"20. Neyman CARA";"20. Neyman CARA";815;206;197;9;988;12
"816";"20. Neyman CARA";"20. Neyman CARA";816;400;106;294;492;508
"817";"20. Neyman CARA";"20. Neyman CARA";817;298;150;148;752;248
"818";"20. Neyman CARA";"20. Neyman CARA";818;411;105;306;491;509
"819";"20. Neyman CARA";"20. Neyman CARA";819;418;100;318;491;509
"820";"20. Neyman CARA";"20. Neyman CARA";820;557;173;384;515;485
"821";"20. Neyman CARA";"20. Neyman CARA";821;420;112;308;483;517
"822";"20. Neyman CARA";"20. Neyman CARA";822;204;201;3;995;5
"823";"20. Neyman CARA";"20. Neyman CARA";823;187;183;4;993;7
"824";"20. Neyman CARA";"20. Neyman CARA";824;206;200;6;992;8
"825";"20. Neyman CARA";"20. Neyman CARA";825;416;89;327;467;533
"826";"20. Neyman CARA";"20. Neyman CARA";826;230;226;4;994;6
"827";"20. Neyman CARA";"20. Neyman CARA";827;202;199;3;993;7
"828";"20. Neyman CARA";"20. Neyman CARA";828;499;150;349;534;466
"829";"20. Neyman CARA";"20. Neyman CARA";829;415;91;324;477;523
"830";"20. Neyman CARA";"20. Neyman CARA";830;201;197;4;994;6
"831";"20. Neyman CARA";"20. Neyman CARA";831;190;184;6;993;7
"832";"20. Neyman CARA";"20. Neyman CARA";832;225;216;9;987;13
"833";"20. Neyman CARA";"20. Neyman CARA";833;421;124;297;513;487
"834";"20. Neyman CARA";"20. Neyman CARA";834;207;202;5;993;7
"835";"20. Neyman CARA";"20. Neyman CARA";835;399;96;303;488;512
"836";"20. Neyman CARA";"20. Neyman CARA";836;408;105;303;505;495
"837";"20. Neyman CARA";"20. Neyman CARA";837;386;96;290;487;513
"838";"20. Neyman CARA";"20. Neyman CARA";838;530;145;385;514;486
"839";"20. Neyman CARA";"20. Neyman CARA";839;402;94;308;477;523
"840";"20. Neyman CARA";"20. Neyman CARA";840;264;57;207;485;515
"841";"20. Neyman CARA";"20. Neyman CARA";841;536;155;381;517;483
"842";"20. Neyman CARA";"20. Neyman CARA";842;407;98;309;502;498
"843";"20. Neyman CARA";"20. Neyman CARA";843;414;125;289;520;480
"844";"20. Neyman CARA";"20. Neyman CARA";844;443;103;340;497;503
"845";"20. Neyman CARA";"20. Neyman CARA";845;395;97;298;492;508
"846";"20. Neyman CARA";"20. Neyman CARA";846;392;108;284;502;498
"847";"20. Neyman CARA";"20. Neyman CARA";847;253;57;196;485;515
"848";"20. Neyman CARA";"20. Neyman CARA";848;380;95;285;484;516
"849";"20. Neyman CARA";"20. Neyman CARA";849;436;90;346;469;531
"850";"20. Neyman CARA";"20. Neyman CARA";850;404;115;289;522;478
"851";"20. Neyman CARA";"20. Neyman CARA";851;482;126;356;523;477
"852";"20. Neyman CARA";"20. Neyman CARA";852;190;186;4;992;8
"853";"20. Neyman CARA";"20. Neyman CARA";853;376;90;286;518;482
"854";"20. Neyman CARA";"20. Neyman CARA";854;536;151;385;515;485
"855";"20. Neyman CARA";"20. Neyman CARA";855;199;196;3;994;6
"856";"20. Neyman CARA";"20. Neyman CARA";856;408;108;300;498;502
"857";"20. Neyman CARA";"20. Neyman CARA";857;544;166;378;515;485
"858";"20. Neyman CARA";"20. Neyman CARA";858;558;182;376;514;486
"859";"20. Neyman CARA";"20. Neyman CARA";859;269;163;106;828;172
"860";"20. Neyman CARA";"20. Neyman CARA";860;390;87;303;478;522
"861";"20. Neyman CARA";"20. Neyman CARA";861;381;93;288;504;496
"862";"20. Neyman CARA";"20. Neyman CARA";862;386;107;279;513;487
"863";"20. Neyman CARA";"20. Neyman CARA";863;389;111;278;549;451
"864";"20. Neyman CARA";"20. Neyman CARA";864;534;142;392;515;485
"865";"20. Neyman CARA";"20. Neyman CARA";865;385;92;293;496;504
"866";"20. Neyman CARA";"20. Neyman CARA";866;401;95;306;485;515
"867";"20. Neyman CARA";"20. Neyman CARA";867;380;95;285;480;520
"868";"20. Neyman CARA";"20. Neyman CARA";868;409;114;295;510;490
"869";"20. Neyman CARA";"20. Neyman CARA";869;523;149;374;526;474
"870";"20. Neyman CARA";"20. Neyman CARA";870;397;97;300;486;514
"871";"20. Neyman CARA";"20. Neyman CARA";871;396;103;293;506;494
"872";"20. Neyman CARA";"20. Neyman CARA";872;519;141;378;515;485
"873";"20. Neyman CARA";"20. Neyman CARA";873;394;93;301;480;520
"874";"20. Neyman CARA";"20. Neyman CARA";874;318;140;178;705;295
"875";"20. Neyman CARA";"20. Neyman CARA";875;389;93;296;509;491
"876";"20. Neyman CARA";"20. Neyman CARA";876;308;160;148;765;235
"877";"20. Neyman CARA";"20. Neyman CARA";877;420;100;320;479;521
"878";"20. Neyman CARA";"20. Neyman CARA";878;415;87;328;459;541
"879";"20. Neyman CARA";"20. Neyman CARA";879;459;129;330;509;491
"880";"20. Neyman CARA";"20. Neyman CARA";880;411;107;304;501;499
"881";"20. Neyman CARA";"20. Neyman CARA";881;203;199;4;994;6
"882";"20. Neyman CARA";"20. Neyman CARA";882;393;115;278;522;478
"883";"20. Neyman CARA";"20. Neyman CARA";883;190;185;5;992;8
"884";"20. Neyman CARA";"20. Neyman CARA";884;549;156;393;513;487
"885";"20. Neyman CARA";"20. Neyman CARA";885;198;194;4;995;5
"886";"20. Neyman CARA";"20. Neyman CARA";886;402;93;309;485;515
"887";"20. Neyman CARA";"20. Neyman CARA";887;549;157;392;531;469
"888";"20. Neyman CARA";"20. Neyman CARA";888;196;194;2;995;5
"889";"20. Neyman CARA";"20. Neyman CARA";889;543;166;377;513;487
"890";"20. Neyman CARA";"20. Neyman CARA";890;404;93;311;484;516
"891";"20. Neyman CARA";"20. Neyman CARA";891;192;187;5;994;6
"892";"20. Neyman CARA";"20. Neyman CARA";892;411;89;322;464;536
"893";"20. Neyman CARA";"20. Neyman CARA";893;400;99;301;492;508
"894";"20. Neyman CARA";"20. Neyman CARA";894;399;99;300;492;508
"895";"20. Neyman CARA";"20. Neyman CARA";895;548;157;391;515;485
"896";"20. Neyman CARA";"20. Neyman CARA";896;202;198;4;995;5
"897";"20. Neyman CARA";"20. Neyman CARA";897;399;121;278;507;493
"898";"20. Neyman CARA";"20. Neyman CARA";898;374;102;272;520;480
"899";"20. Neyman CARA";"20. Neyman CARA";899;290;173;117;812;188
"900";"20. Neyman CARA";"20. Neyman CARA";900;417;104;313;501;499
"901";"20. Neyman CARA";"20. Neyman CARA";901;388;108;280;534;466
"902";"20. Neyman CARA";"20. Neyman CARA";902;185;183;2;995;5
"903";"20. Neyman CARA";"20. Neyman CARA";903;542;151;391;515;485
"904";"20. Neyman CARA";"20. Neyman CARA";904;190;187;3;995;5
"905";"20. Neyman CARA";"20. Neyman CARA";905;411;114;297;480;520
"906";"20. Neyman CARA";"20. Neyman CARA";906;385;96;289;501;499
"907";"20. Neyman CARA";"20. Neyman CARA";907;539;147;392;514;486
"908";"20. Neyman CARA";"20. Neyman CARA";908;375;99;276;512;488
"909";"20. Neyman CARA";"20. Neyman CARA";909;541;143;398;512;488
"910";"20. Neyman CARA";"20. Neyman CARA";910;403;94;309;496;504
"911";"20. Neyman CARA";"20. Neyman CARA";911;239;181;58;914;86
"912";"20. Neyman CARA";"20. Neyman CARA";912;503;138;365;524;476
"913";"20. Neyman CARA";"20. Neyman CARA";913;403;95;308;513;487
"914";"20. Neyman CARA";"20. Neyman CARA";914;214;209;5;994;6
"915";"20. Neyman CARA";"20. Neyman CARA";915;213;211;2;995;5
"916";"20. Neyman CARA";"20. Neyman CARA";916;468;131;337;524;476
"917";"20. Neyman CARA";"20. Neyman CARA";917;393;106;287;519;481
"918";"20. Neyman CARA";"20. Neyman CARA";918;405;112;293;510;490
"919";"20. Neyman CARA";"20. Neyman CARA";919;395;76;319;466;534
"920";"20. Neyman CARA";"20. Neyman CARA";920;404;89;315;470;530
"921";"20. Neyman CARA";"20. Neyman CARA";921;515;134;381;516;484
"922";"20. Neyman CARA";"20. Neyman CARA";922;378;82;296;489;511
"923";"20. Neyman CARA";"20. Neyman CARA";923;218;212;6;993;7
"924";"20. Neyman CARA";"20. Neyman CARA";924;394;93;301;473;527
"925";"20. Neyman CARA";"20. Neyman CARA";925;209;203;6;992;8
"926";"20. Neyman CARA";"20. Neyman CARA";926;206;201;5;993;7
"927";"20. Neyman CARA";"20. Neyman CARA";927;460;117;343;512;488
"928";"20. Neyman CARA";"20. Neyman CARA";928;493;140;353;513;487
"929";"20. Neyman CARA";"20. Neyman CARA";929;396;89;307;492;508
"930";"20. Neyman CARA";"20. Neyman CARA";930;388;103;285;509;491
"931";"20. Neyman CARA";"20. Neyman CARA";931;198;194;4;995;5
"932";"20. Neyman CARA";"20. Neyman CARA";932;402;102;300;481;519
"933";"20. Neyman CARA";"20. Neyman CARA";933;285;169;116;810;190
"934";"20. Neyman CARA";"20. Neyman CARA";934;505;131;374;502;498
"935";"20. Neyman CARA";"20. Neyman CARA";935;521;151;370;516;484
"936";"20. Neyman CARA";"20. Neyman CARA";936;212;206;6;993;7
"937";"20. Neyman CARA";"20. Neyman CARA";937;389;105;284;498;502
"938";"20. Neyman CARA";"20. Neyman CARA";938;244;40;204;485;515
"939";"20. Neyman CARA";"20. Neyman CARA";939;541;150;391;515;485
"940";"20. Neyman CARA";"20. Neyman CARA";940;199;196;3;995;5
"941";"20. Neyman CARA";"20. Neyman CARA";941;392;103;289;503;497
"942";"20. Neyman CARA";"20. Neyman CARA";942;190;187;3;995;5
"943";"20. Neyman CARA";"20. Neyman CARA";943;226;223;3;994;6
"944";"20. Neyman CARA";"20. Neyman CARA";944;402;114;288;505;495
"945";"20. Neyman CARA";"20. Neyman CARA";945;278;152;126;769;231
"946";"20. Neyman CARA";"20. Neyman CARA";946;424;98;326;498;502
"947";"20. Neyman CARA";"20. Neyman CARA";947;384;106;278;523;477
"948";"20. Neyman CARA";"20. Neyman CARA";948;421;105;316;501;499
"949";"20. Neyman CARA";"20. Neyman CARA";949;212;208;4;994;6
"950";"20. Neyman CARA";"20. Neyman CARA";950;540;153;387;516;484
"951";"20. Neyman CARA";"20. Neyman CARA";951;532;145;387;515;485
"952";"20. Neyman CARA";"20. Neyman CARA";952;397;93;304;496;504
"953";"20. Neyman CARA";"20. Neyman CARA";953;541;151;390;516;484
"954";"20. Neyman CARA";"20. Neyman CARA";954;415;104;311;479;521
"955";"20. Neyman CARA";"20. Neyman CARA";955;393;94;299;480;520
"956";"20. Neyman CARA";"20. Neyman CARA";956;377;143;234;611;389
"957";"20. Neyman CARA";"20. Neyman CARA";957;396;122;274;524;476
"958";"20. Neyman CARA";"20. Neyman CARA";958;289;177;112;812;188
"959";"20. Neyman CARA";"20. Neyman CARA";959;377;84;293;525;475
"960";"20. Neyman CARA";"20. Neyman CARA";960;416;98;318;496;504
"961";"20. Neyman CARA";"20. Neyman CARA";961;519;137;382;517;483
"962";"20. Neyman CARA";"20. Neyman CARA";962;392;88;304;495;505
"963";"20. Neyman CARA";"20. Neyman CARA";963;207;203;4;993;7
"964";"20. Neyman CARA";"20. Neyman CARA";964;379;83;296;482;518
"965";"20. Neyman CARA";"20. Neyman CARA";965;246;48;198;485;515
"966";"20. Neyman CARA";"20. Neyman CARA";966;511;154;357;528;472
"967";"20. Neyman CARA";"20. Neyman CARA";967;207;203;4;995;5
"968";"20. Neyman CARA";"20. Neyman CARA";968;292;162;130;746;254
"969";"20. Neyman CARA";"20. Neyman CARA";969;214;208;6;992;8
"970";"20. Neyman CARA";"20. Neyman CARA";970;529;150;379;518;482
"971";"20. Neyman CARA";"20. Neyman CARA";971;201;197;4;994;6
"972";"20. Neyman CARA";"20. Neyman CARA";972;517;133;384;512;488
"973";"20. Neyman CARA";"20. Neyman CARA";973;412;117;295;509;491
"974";"20. Neyman CARA";"20. Neyman CARA";974;399;102;297;500;500
"975";"20. Neyman CARA";"20. Neyman CARA";975;419;109;310;490;510
"976";"20. Neyman CARA";"20. Neyman CARA";976;378;117;261;550;450
"977";"20. Neyman CARA";"20. Neyman CARA";977;263;201;62;906;94
"978";"20. Neyman CARA";"20. Neyman CARA";978;389;106;283;508;492
"979";"20. Neyman CARA";"20. Neyman CARA";979;552;155;397;513;487
"980";"20. Neyman CARA";"20. Neyman CARA";980;210;205;5;994;6
"981";"20. Neyman CARA";"20. Neyman CARA";981;210;205;5;991;9
"982";"20. Neyman CARA";"20. Neyman CARA";982;408;113;295;506;494
"983";"20. Neyman CARA";"20. Neyman CARA";983;553;25;528;110;890
"984";"20. Neyman CARA";"20. Neyman CARA";984;516;167;349;514;486
"985";"20. Neyman CARA";"20. Neyman CARA";985;210;206;4;995;5
"986";"20. Neyman CARA";"20. Neyman CARA";986;541;152;389;515;485
"987";"20. Neyman CARA";"20. Neyman CARA";987;193;190;3;995;5
"988";"20. Neyman CARA";"20. Neyman CARA";988;205;201;4;995;5
"989";"20. Neyman CARA";"20. Neyman CARA";989;210;206;4;994;6
"990";"20. Neyman CARA";"20. Neyman CARA";990;396;90;306;475;525
"991";"20. Neyman CARA";"20. Neyman CARA";991;213;208;5;993;7
"992";"20. Neyman CARA";"20. Neyman CARA";992;409;111;298;502;498
"993";"20. Neyman CARA";"20. Neyman CARA";993;402;97;305;508;492
"994";"20. Neyman CARA";"20. Neyman CARA";994;535;155;380;512;488
"995";"20. Neyman CARA";"20. Neyman CARA";995;404;114;290;502;498
"996";"20. Neyman CARA";"20. Neyman CARA";996;387;100;287;516;484
"997";"20. Neyman CARA";"20. Neyman CARA";997;571;172;399;516;484
"998";"20. Neyman CARA";"20. Neyman CARA";998;201;195;6;991;9
"999";"20. Neyman CARA";"20. Neyman CARA";999;417;89;328;455;545
"1000";"20";"20. Neyman CARA";1000;397;94;303;506;494
